concept_athlete_aaron_kampman	concept_stadiumoreventvenue_pete_times_forum
concept_athlete_aaron_williams	concept_stadiumoreventvenue_staples_center
concept_athlete_abreu	concept_stadiumoreventvenue_yankee_stadium
concept_athlete_adam_burish	concept_stadiumoreventvenue_wrigley_field
concept_athlete_adam_jones	concept_stadiumoreventvenue_camden_yards
concept_athlete_adam_loewen	concept_stadiumoreventvenue_camden_yards
concept_athlete_adam_morrison	concept_stadiumoreventvenue_dodger_stadium
concept_athlete_adam_morrison	concept_stadiumoreventvenue_time_warner_cable_arena
concept_athlete_adam_russell	concept_stadiumoreventvenue_fenway
concept_athlete_adrian_aucoin	concept_stadiumoreventvenue_wrigley_field
concept_athlete_adrian_beltre	concept_stadiumoreventvenue_safeco_field
concept_athlete_adrian_griffin	concept_stadiumoreventvenue_madison_square_garden
concept_athlete_ahmad_bradshaw	concept_stadiumoreventvenue_giants_stadium
concept_athlete_akinori_iwamura	concept_stadiumoreventvenue_tropicana_field
concept_athlete_albert_pujols	concept_stadiumoreventvenue_busch_memorial_stadium
concept_athlete_alex_ovechkin	concept_stadiumoreventvenue_verizon_center
concept_athlete_alex_rios	concept_stadiumoreventvenue_rogers_centre
concept_athlete_alexander_semin	concept_stadiumoreventvenue_verizon_center
concept_athlete_alexei_ramirez	concept_stadiumoreventvenue_us_cellular_field
concept_athlete_allan_houston	concept_stadiumoreventvenue_madison_square_garden
concept_athlete_amani_toomer	concept_stadiumoreventvenue_giants_stadium
concept_athlete_amare_stoudemire	concept_stadiumoreventvenue_us_airways_center
concept_athlete_andray_blatche	concept_stadiumoreventvenue_verizon_center
concept_athlete_andre_brown	concept_stadiumoreventvenue_wachovia_center
concept_athlete_andrea_bargnani	concept_stadiumoreventvenue_air_canada_center
concept_athlete_andrei_kirilenko	concept_stadiumoreventvenue_energysolutions_arena
concept_athlete_andres_nocioni	concept_stadiumoreventvenue_united_center
concept_athlete_andrew_bogut	concept_stadiumoreventvenue_staples_center
concept_athlete_andrew_shaw	concept_stadiumoreventvenue_wrigley_field
concept_athlete_andruw_jones	concept_stadiumoreventvenue_turner_field
concept_athlete_andy_sonnanstine	concept_stadiumoreventvenue_tropicana_field
concept_athlete_antawn_jamison	concept_stadiumoreventvenue_oracle_arena
concept_athlete_antawn_jamison	concept_stadiumoreventvenue_verizon_center
concept_athlete_anthony_parker	concept_stadiumoreventvenue_air_canada_center
concept_athlete_antonio_daniels	concept_stadiumoreventvenue_verizon_center
concept_athlete_antonio_mcdyess	concept_stadiumoreventvenue_palace_of_auburn_hills
concept_athlete_antonio_mcdyess	concept_stadiumoreventvenue_quicken_loans_arena
concept_athlete_antonio_pierce	concept_stadiumoreventvenue_giants_stadium
concept_athlete_aramis_ramirez	concept_stadiumoreventvenue_wrigley_field
concept_athlete_ariza	concept_stadiumoreventvenue_staples_center
concept_athlete_b_j__surhoff	concept_stadiumoreventvenue_camden_yards
concept_athlete_b_j__upton	concept_stadiumoreventvenue_pete_times_forum
concept_athlete_babe_ruth	concept_stadiumoreventvenue_yankee_stadium
concept_athlete_baldelli	concept_stadiumoreventvenue_fenway
concept_athlete_baron_davis	concept_stadiumoreventvenue_oracle_arena
concept_athlete_baron_davis	concept_stadiumoreventvenue_staples_center
concept_athlete_barry_bonds	concept_stadiumoreventvenue_giants_stadium
concept_athlete_battier	concept_stadiumoreventvenue_toyota_center
concept_athlete_beltran	concept_stadiumoreventvenue_shea_stadium
concept_athlete_ben_eager	concept_stadiumoreventvenue_wrigley_field
concept_athlete_bernie_kosar	concept_stadiumoreventvenue_cleveland_browns_stadium
concept_athlete_bernie_williams	concept_stadiumoreventvenue_yankee_stadium
concept_athlete_bibby	concept_stadiumoreventvenue_philips_arena
concept_athlete_big_ben	concept_stadiumoreventvenue_heinz_field
concept_athlete_bill_dickey	concept_stadiumoreventvenue_yankee_stadium
concept_athlete_billy_wagner	concept_stadiumoreventvenue_shea_stadium
concept_athlete_blair_betts	concept_stadiumoreventvenue_giants_stadium
concept_athlete_blake	concept_stadiumoreventvenue_dodger_stadium
concept_athlete_bobby_hull	concept_stadiumoreventvenue_wrigley_field
concept_athlete_bobby_orr	concept_stadiumoreventvenue_wrigley_field
concept_athlete_bojan_krkic	concept_stadiumoreventvenue_camp_nou
concept_athlete_bonds	concept_stadiumoreventvenue_candlestick_park
concept_athlete_bonds	concept_stadiumoreventvenue_giants_stadium
concept_athlete_boozer	concept_stadiumoreventvenue_energysolutions_arena
concept_athlete_bosh	concept_stadiumoreventvenue_air_canada_center
concept_athlete_brad_johnson	concept_stadiumoreventvenue_texas_stadium
concept_athlete_brad_penny	concept_stadiumoreventvenue_dodger_stadium
concept_athlete_brandan_wright	concept_stadiumoreventvenue_oracle_arena
concept_athlete_brandon_marshall	concept_stadiumoreventvenue_invesco_field
concept_athlete_brandon_phillips	concept_stadiumoreventvenue_great_american_ball_park
concept_athlete_brandon_webb	concept_stadiumoreventvenue_chase_field
concept_athlete_brent_barry	concept_stadiumoreventvenue_american_airlines_arena
concept_athlete_brent_barry	concept_stadiumoreventvenue_verizon_center
concept_athlete_brent_johnson	concept_stadiumoreventvenue_verizon_center
concept_athlete_brent_seabrook	concept_stadiumoreventvenue_wrigley_field
concept_athlete_brent_sopel	concept_stadiumoreventvenue_wrigley_field
concept_athlete_brett_farve	concept_stadiumoreventvenue_giants_stadium
concept_athlete_brett_gardner	concept_stadiumoreventvenue_yankee_stadium
concept_athlete_brevin_knight	concept_stadiumoreventvenue_quicken_loans_arena
concept_athlete_brian_campbell	concept_stadiumoreventvenue_wrigley_field
concept_athlete_brian_gionta	concept_stadiumoreventvenue_prudential_center_2
concept_athlete_brian_griese	concept_stadiumoreventvenue_soldier_field
concept_athlete_brian_rafalski	concept_stadiumoreventvenue_joe_louis_arena
concept_athlete_brian_roberts	concept_stadiumoreventvenue_camden_yards
concept_athlete_brian_schneider	concept_stadiumoreventvenue_shea_stadium
concept_athlete_brian_wilson	concept_stadiumoreventvenue_giants_stadium
concept_athlete_brodeur	concept_stadiumoreventvenue_prudential_center_2
concept_athlete_brodie_croyle	concept_stadiumoreventvenue_arrowhead_stadium
concept_athlete_bronson_arroyo	concept_stadiumoreventvenue_great_american_ball_park
concept_athlete_brooks_laich	concept_stadiumoreventvenue_verizon_center
concept_athlete_bryan_robson	concept_stadiumoreventvenue_old_trafford
concept_athlete_bryzgalov	concept_stadiumoreventvenue_honda_center
concept_athlete_bud_harrelson	concept_stadiumoreventvenue_shea_stadium
concept_athlete_bulger	concept_stadiumoreventvenue_dome
concept_athlete_burrell	concept_stadiumoreventvenue_tropicana_field
concept_athlete_cam_ward	concept_stadiumoreventvenue_bank_atlantic_center
concept_athlete_carl_crawford	concept_stadiumoreventvenue_pete_times_forum
concept_athlete_carl_landry	concept_stadiumoreventvenue_toyota_center
concept_athlete_carl_pavano	concept_stadiumoreventvenue_yankee_stadium
concept_athlete_carl_yastrzemski	concept_stadiumoreventvenue_fenway
concept_athlete_carlos_beltran	concept_stadiumoreventvenue_shea_stadium
concept_athlete_carlos_boozer	concept_stadiumoreventvenue_energysolutions_arena
concept_athlete_carlos_pena	concept_stadiumoreventvenue_tropicana_field
concept_athlete_carlos_tevez	concept_stadiumoreventvenue_old_trafford
concept_athlete_carlos_zambrano	concept_stadiumoreventvenue_wrigley_field
concept_athlete_carmelo_anthony	concept_stadiumoreventvenue_pepsi_center
concept_athlete_carson_palmer	concept_stadiumoreventvenue_great_american_ball_park
concept_athlete_casey_blake	concept_stadiumoreventvenue_dodger_stadium
concept_athlete_casey_stengel	concept_stadiumoreventvenue_yankee_stadium
concept_athlete_cc_sabathia	concept_stadiumoreventvenue_yankee_stadium
concept_athlete_cedric_benson	concept_stadiumoreventvenue_soldier_field
concept_athlete_chad_billingsley	concept_stadiumoreventvenue_dodger_stadium
concept_athlete_chad_hutchinson	concept_stadiumoreventvenue_texas_stadium
concept_athlete_chad_johnson	concept_stadiumoreventvenue_great_american_ball_park
concept_athlete_champ_bailey	concept_stadiumoreventvenue_invesco_field
concept_athlete_chan_ho_park	concept_stadiumoreventvenue_pete_times_forum
concept_athlete_charles_barkley	concept_stadiumoreventvenue_toyota_center
concept_athlete_charles_scott	concept_stadiumoreventvenue_tiger_stadium
concept_athlete_charlie_bell	concept_stadiumoreventvenue_madison_square_garden
concept_athlete_charlie_frye	concept_stadiumoreventvenue_cleveland_browns_stadium
concept_athlete_charlie_villanueva	concept_stadiumoreventvenue_air_canada_center
concept_athlete_chauncey_billups	concept_stadiumoreventvenue_palace_of_auburn_hills
concept_athlete_chelios	concept_stadiumoreventvenue_joe_louis_arena
concept_athlete_chipper_jones	concept_stadiumoreventvenue_turner_field
concept_athlete_chris_bosh	concept_stadiumoreventvenue_air_canada_center
concept_athlete_chris_chelios	concept_stadiumoreventvenue_wrigley_field
concept_athlete_chris_cooley	concept_stadiumoreventvenue_fedex_field
concept_athlete_chris_duhon	concept_stadiumoreventvenue_madison_square_garden
concept_athlete_chris_kunitz	concept_stadiumoreventvenue_honda_center
concept_athlete_chris_mason	concept_stadiumoreventvenue_bridgestone_arena
concept_athlete_chris_mihm	concept_stadiumoreventvenue_quicken_loans_arena
concept_athlete_chris_osgood	concept_stadiumoreventvenue_joe_louis_arena
concept_athlete_chris_redman	concept_stadiumoreventvenue_georgia_dome
concept_athlete_chris_snyder	concept_stadiumoreventvenue_chase_field
concept_athlete_chuck_james	concept_stadiumoreventvenue_turner_field
concept_athlete_chucky_atkins	concept_stadiumoreventvenue_amway_arena
concept_athlete_clay_buchholz	concept_stadiumoreventvenue_fenway
concept_athlete_clayton_kershaw	concept_stadiumoreventvenue_dodger_stadium
concept_athlete_clemens	concept_stadiumoreventvenue_yankee_stadium
concept_athlete_cleon_jones	concept_stadiumoreventvenue_shea_stadium
concept_athlete_cliff_floyd	concept_stadiumoreventvenue_tropicana_field
concept_athlete_clyde_drexler	concept_stadiumoreventvenue_toyota_center
concept_athlete_coco_crisp	concept_stadiumoreventvenue_fenway
concept_athlete_coco_crisp_	concept_stadiumoreventvenue_fenway
concept_athlete_colin_long	concept_stadiumoreventvenue_toyota_center
concept_athlete_conor_jackson	concept_stadiumoreventvenue_chase_field
concept_athlete_corey_maggette	concept_stadiumoreventvenue_staples_center
concept_athlete_corey_perry	concept_stadiumoreventvenue_honda_center
concept_athlete_corey_webster	concept_stadiumoreventvenue_giants_stadium
concept_athlete_craig_anderson	concept_stadiumoreventvenue_bank_atlantic_center
concept_athlete_craig_conroy	concept_stadiumoreventvenue_pengrowth_saddledome
concept_athlete_crede	concept_stadiumoreventvenue_giants_stadium
concept_athlete_cristiano_ronaldo	concept_stadiumoreventvenue_old_trafford
concept_athlete_cristobal_huet	concept_stadiumoreventvenue_wrigley_field
concept_athlete_crosby	concept_stadiumoreventvenue_mellon_arena
concept_athlete_curt_schilling	concept_stadiumoreventvenue_fenway
concept_athlete_curtis_martin	concept_stadiumoreventvenue_giants_stadium
concept_athlete_cuttino_mobley	concept_stadiumoreventvenue_toyota_center
concept_athlete_daequan_cook	concept_stadiumoreventvenue_american_airlines_arena
concept_athlete_damon	concept_stadiumoreventvenue_yankee_stadium
concept_athlete_dan_boyle	concept_stadiumoreventvenue_hp_pavilion
concept_athlete_dan_carcillo	concept_stadiumoreventvenue_wrigley_field
concept_athlete_dan_cleary	concept_stadiumoreventvenue_joe_louis_arena
concept_athlete_dan_fouts	concept_stadiumoreventvenue_qualcomm_stadium
concept_athlete_dan_haren	concept_stadiumoreventvenue_chase_field
concept_athlete_danilo_gallinari	concept_stadiumoreventvenue_madison_square_garden
concept_athlete_dany_heatley	concept_stadiumoreventvenue_hp_pavilion
concept_athlete_darius_miles	concept_stadiumoreventvenue_fedex_forum
concept_athlete_darius_miles	concept_stadiumoreventvenue_staples_center
concept_athlete_darius_songaila	concept_stadiumoreventvenue_american_airlines_arena
concept_athlete_darius_songaila	concept_stadiumoreventvenue_td_garden
concept_athlete_darrell_rasner	concept_stadiumoreventvenue_yankee_stadium
concept_athlete_darrelle_revis	concept_stadiumoreventvenue_giants_stadium
concept_athlete_darren_mcfadden	concept_stadiumoreventvenue_mcafee_coliseum
concept_athlete_darren_sproles	concept_stadiumoreventvenue_qualcomm_stadium
concept_athlete_darrent_williams	concept_stadiumoreventvenue_invesco_field
concept_athlete_darrick_martin	concept_stadiumoreventvenue_arrowhead_stadium
concept_athlete_dave_bolland	concept_stadiumoreventvenue_wrigley_field
concept_athlete_david_justice	concept_stadiumoreventvenue_yankee_stadium
concept_athlete_david_moss	concept_stadiumoreventvenue_pengrowth_saddledome
concept_athlete_david_ortiz	concept_stadiumoreventvenue_fenway
concept_athlete_david_wells	concept_stadiumoreventvenue_yankee_stadium
concept_athlete_daymond_langkow	concept_stadiumoreventvenue_pengrowth_saddledome
concept_athlete_deion_branch	concept_stadiumoreventvenue_husky_stadium
concept_athlete_delonte_west	concept_stadiumoreventvenue_quicken_loans_arena
concept_athlete_deltha_o_neal	concept_stadiumoreventvenue_us_airways_center
concept_athlete_demarcus_ware	concept_stadiumoreventvenue_texas_stadium
concept_athlete_derek_lowe	concept_stadiumoreventvenue_dodger_stadium
concept_athlete_deron_williams	concept_stadiumoreventvenue_energysolutions_arena
concept_athlete_derosa	concept_stadiumoreventvenue_wrigley_field
concept_athlete_derrick_turnbow	concept_stadiumoreventvenue_yankee_stadium
concept_athlete_desmond_mason	concept_stadiumoreventvenue_time_warner_cable_arena
concept_athlete_diaw	concept_stadiumoreventvenue_us_airways_center
concept_athlete_dikembe_mutombo	concept_stadiumoreventvenue_toyota_center
concept_athlete_dimitar_berbatov	concept_stadiumoreventvenue_old_trafford
concept_athlete_dion_phaneuf	concept_stadiumoreventvenue_scotiabank_saddledome
concept_athlete_dioner_navarro	concept_stadiumoreventvenue_tropicana_field
concept_athlete_dirk_kuyt	concept_stadiumoreventvenue_anfield
concept_athlete_dirk_nowitzki	concept_stadiumoreventvenue_american_airlines_center
concept_athlete_dmitri_young	concept_stadiumoreventvenue_comerica
concept_athlete_dom_dimaggio	concept_stadiumoreventvenue_fenway
concept_athlete_dominik_hasek	concept_stadiumoreventvenue_joe_louis_arena
concept_athlete_don_larsen	concept_stadiumoreventvenue_yankee_stadium
concept_athlete_donnie_avery	concept_stadiumoreventvenue_dome
concept_athlete_dontrelle_willis	concept_stadiumoreventvenue_dolphin_stadium
concept_athlete_doug_williams	concept_stadiumoreventvenue_fedex_field
concept_athlete_duncan_keith	concept_stadiumoreventvenue_wrigley_field
concept_athlete_dustin_byfuglien	concept_stadiumoreventvenue_wrigley_field
concept_athlete_dustin_keller	concept_stadiumoreventvenue_giants_stadium
concept_athlete_dustin_pedroia	concept_stadiumoreventvenue_fenway
concept_athlete_dwight_freeney	concept_stadiumoreventvenue_lucas_oil_stadium
concept_athlete_dwight_lowery	concept_stadiumoreventvenue_giants_stadium
concept_athlete_dwyane_wade	concept_stadiumoreventvenue_american_airlines_arena
concept_athlete_dye	concept_stadiumoreventvenue_us_cellular_field
concept_athlete_ed_belfour	concept_stadiumoreventvenue_wrigley_field
concept_athlete_eddy_curry	concept_stadiumoreventvenue_madison_square_garden
concept_athlete_eli_manning	concept_stadiumoreventvenue_giants_stadium
concept_athlete_elton_brand	concept_stadiumoreventvenue_staples_center
concept_athlete_elvin_ramirez	concept_stadiumoreventvenue_dodger_stadium
concept_athlete_emmitt_smith	concept_stadiumoreventvenue_texas_stadium
concept_athlete_eric_byrnes	concept_stadiumoreventvenue_chase_field
concept_athlete_eric_gordon	concept_stadiumoreventvenue_staples_center
concept_athlete_eric_milton	concept_stadiumoreventvenue_yankee_stadium
concept_athlete_eric_staal	concept_stadiumoreventvenue_bank_atlantic_center
concept_athlete_erik_bedard	concept_stadiumoreventvenue_camden_yards
concept_athlete_ernie_banks	concept_stadiumoreventvenue_wrigley_field
concept_athlete_esteban_loaiza	concept_stadiumoreventvenue_dodger_stadium
concept_athlete_ethier	concept_stadiumoreventvenue_dodger_stadium
concept_athlete_eto_o	concept_stadiumoreventvenue_camp_nou
concept_athlete_evgeny_artyukhin	concept_stadiumoreventvenue_pete_times_forum
concept_athlete_farmar	concept_stadiumoreventvenue_staples_center
concept_athlete_farve	concept_stadiumoreventvenue_giants_stadium
concept_athlete_favre	concept_stadiumoreventvenue_giants_stadium
concept_athlete_favre	concept_stadiumoreventvenue_pete_times_forum
concept_athlete_felix_hernandez	concept_stadiumoreventvenue_safeco_field
concept_athlete_felix_pie	concept_stadiumoreventvenue_wrigley_field
concept_athlete_fernando_abad	concept_stadiumoreventvenue_camden_yards
concept_athlete_fernando_tatis	concept_stadiumoreventvenue_shea_stadium
concept_athlete_frank	concept_stadiumoreventvenue_toyota_center
concept_athlete_freddy_garcia	concept_stadiumoreventvenue_us_cellular_field
concept_athlete_freddy_sanchez	concept_stadiumoreventvenue_shea_stadium
concept_athlete_gabe_kapler	concept_stadiumoreventvenue_tropicana_field
concept_athlete_garret_anderson	concept_stadiumoreventvenue_old_trafford
concept_athlete_garrett_olson	concept_stadiumoreventvenue_camden_yards
concept_athlete_gary_carter	concept_stadiumoreventvenue_dolphin_stadium
concept_athlete_gary_sheffield	concept_stadiumoreventvenue_yankee_stadium
concept_athlete_gasol	concept_stadiumoreventvenue_staples_center
concept_athlete_gavin_floyd	concept_stadiumoreventvenue_us_cellular_field
concept_athlete_gehrig	concept_stadiumoreventvenue_yankee_stadium
concept_athlete_georges_laraque	concept_stadiumoreventvenue_mellon_arena
concept_athlete_glavine	concept_stadiumoreventvenue_shea_stadium
concept_athlete_granger	concept_stadiumoreventvenue_conseco_fieldhouse
concept_athlete_grant_hill	concept_stadiumoreventvenue_us_airways_center
concept_athlete_greg_ellis	concept_stadiumoreventvenue_texas_stadium
concept_athlete_greg_maddux	concept_stadiumoreventvenue_dodger_stadium
concept_athlete_griffey	concept_stadiumoreventvenue_great_american_ball_park
concept_athlete_hanley_ramirez	concept_stadiumoreventvenue_dolphin_stadium
concept_athlete_harrison	concept_stadiumoreventvenue_heinz_field
concept_athlete_harrison	concept_stadiumoreventvenue_lucas_oil_stadium
concept_athlete_harry_kewell	concept_stadiumoreventvenue_anfield
concept_athlete_hassan_adams	concept_stadiumoreventvenue_philips_arena
concept_athlete_hasselbeck	concept_stadiumoreventvenue_husky_stadium
concept_athlete_haynesworth	concept_stadiumoreventvenue_lp_field
concept_athlete_heath_bell	concept_stadiumoreventvenue_staples_center
concept_athlete_henrik_zetterberg	concept_stadiumoreventvenue_joe_louis_arena
concept_athlete_henry	concept_stadiumoreventvenue_camp_nou
concept_athlete_hideki_okajima	concept_stadiumoreventvenue_yankee_stadium
concept_athlete_hideo_nomo	concept_stadiumoreventvenue_dodger_stadium
concept_athlete_hiroki_kuroda	concept_stadiumoreventvenue_dodger_stadium
concept_athlete_homer_bailey	concept_stadiumoreventvenue_great_american_ball_park
concept_athlete_huet	concept_stadiumoreventvenue_wrigley_field
concept_athlete_ichiro	concept_stadiumoreventvenue_safeco_field
concept_athlete_ichiro_suzuki	concept_stadiumoreventvenue_safeco_field
concept_athlete_ivan_rodriguez	concept_stadiumoreventvenue_yankee_stadium
concept_athlete_iverson	concept_stadiumoreventvenue_palace_of_auburn_hills
concept_athlete_j_j__putz	concept_stadiumoreventvenue_shea_stadium
concept_athlete_j_p__losman	concept_stadiumoreventvenue_ralph_wilson_stadium
concept_athlete_jacoby_ellsbury	concept_stadiumoreventvenue_fenway
concept_athlete_jair_jurrjens	concept_stadiumoreventvenue_turner_field
concept_athlete_jake_peavy	concept_stadiumoreventvenue_qualcomm_stadium
concept_athlete_jamaal_tinsley	concept_stadiumoreventvenue_conseco_fieldhouse
concept_athlete_jamario_moon	concept_stadiumoreventvenue_air_canada_center
concept_athlete_jameer_nelson	concept_stadiumoreventvenue_amway_arena
concept_athlete_james_farrior	concept_stadiumoreventvenue_heinz_field
concept_athlete_james_harrison	concept_stadiumoreventvenue_heinz_field
concept_athlete_james_loney	concept_stadiumoreventvenue_dodger_stadium
concept_athlete_james_posey	concept_stadiumoreventvenue_pepsi_center
concept_athlete_james_shields	concept_stadiumoreventvenue_tropicana_field
concept_athlete_jared_allen	concept_stadiumoreventvenue_metrodome
concept_athlete_jared_reiner	concept_stadiumoreventvenue_staples_center
concept_athlete_jarome_iginla	concept_stadiumoreventvenue_scotiabank_saddledome
concept_athlete_jarvis_hayes	concept_stadiumoreventvenue_verizon_center
concept_athlete_jason_kapono	concept_stadiumoreventvenue_air_canada_center
concept_athlete_jason_kidd	concept_stadiumoreventvenue_us_airways_center
concept_athlete_jason_marquis	concept_stadiumoreventvenue_wrigley_field
concept_athlete_jason_richardson	concept_stadiumoreventvenue_oracle_arena
concept_athlete_jason_varitek	concept_stadiumoreventvenue_fenway
concept_athlete_javier_mascherano	concept_stadiumoreventvenue_anfield
concept_athlete_javier_vazquez	concept_stadiumoreventvenue_us_cellular_field
concept_athlete_javon_walker	concept_stadiumoreventvenue_invesco_field
concept_athlete_jay_cutler	concept_stadiumoreventvenue_invesco_field
concept_athlete_jay_pandolfo	concept_stadiumoreventvenue_prudential_center_2
concept_athlete_jay_payton	concept_stadiumoreventvenue_camden_yards
concept_athlete_jed_lowrie	concept_stadiumoreventvenue_fenway
concept_athlete_jeff_francoeur	concept_stadiumoreventvenue_turner_field
concept_athlete_jeff_garcia	concept_stadiumoreventvenue_staples_center
concept_athlete_jeff_kent	concept_stadiumoreventvenue_dodger_stadium
concept_athlete_jeff_samardzija	concept_stadiumoreventvenue_wrigley_field
concept_athlete_jeremy_hermida	concept_stadiumoreventvenue_dolphin_stadium
concept_athlete_jermaine_o_neal	concept_stadiumoreventvenue_air_canada_center
concept_athlete_jermaine_o_neal	concept_stadiumoreventvenue_conseco_fieldhouse
concept_athlete_jerome_bettis	concept_stadiumoreventvenue_heinz_field
concept_athlete_jerome_james	concept_stadiumoreventvenue_new_orleans_arena
concept_athlete_jerry_stackhouse	concept_stadiumoreventvenue_wachovia_center
concept_athlete_jerry_west	concept_stadiumoreventvenue_staples_center
concept_athlete_jeter	concept_stadiumoreventvenue_yankee_stadium
concept_athlete_jim_edmonds	concept_stadiumoreventvenue_wrigley_field
concept_athlete_jim_rice	concept_stadiumoreventvenue_fenway
concept_athlete_jimmy_howard	concept_stadiumoreventvenue_joe_louis_arena
concept_athlete_jiri_hudler	concept_stadiumoreventvenue_joe_louis_arena
concept_athlete_joba_chamberlain	concept_stadiumoreventvenue_yankee_stadium
concept_athlete_joe_dimaggio	concept_stadiumoreventvenue_yankee_stadium
concept_athlete_joe_girardi	concept_stadiumoreventvenue_yankee_stadium
concept_athlete_joe_gordon	concept_stadiumoreventvenue_yankee_stadium
concept_athlete_joe_namath	concept_stadiumoreventvenue_giants_stadium
concept_athlete_joe_pepitone	concept_stadiumoreventvenue_yankee_stadium
concept_athlete_joe_sakic	concept_stadiumoreventvenue_pepsi_center
concept_athlete_joe_thornton	concept_stadiumoreventvenue_hp_pavilion
concept_athlete_joey_harrington	concept_stadiumoreventvenue_georgia_dome
concept_athlete_joey_macdonald	concept_stadiumoreventvenue_nassau_coliseum
concept_athlete_joey_porter	concept_stadiumoreventvenue_heinz_field
concept_athlete_johan_franzen	concept_stadiumoreventvenue_joe_louis_arena
concept_athlete_johan_santana	concept_stadiumoreventvenue_shea_stadium
concept_athlete_john_barnes	concept_stadiumoreventvenue_anfield
concept_athlete_john_madden	concept_stadiumoreventvenue_prudential_center_2
concept_athlete_john_smoltz	concept_stadiumoreventvenue_turner_field
concept_athlete_john_ward	concept_stadiumoreventvenue_heinz_field
concept_athlete_johnny_cueto	concept_stadiumoreventvenue_great_american_ball_park
concept_athlete_jon_lester	concept_stadiumoreventvenue_fenway
concept_athlete_jonathan_sanchez	concept_stadiumoreventvenue_giants_stadium
concept_athlete_jonathan_toews	concept_stadiumoreventvenue_wrigley_field
concept_athlete_jones	concept_stadiumoreventvenue_texas_stadium
concept_athlete_jordan_staal	concept_stadiumoreventvenue_mellon_arena
concept_athlete_jordin_tootoo	concept_stadiumoreventvenue_bridgestone_arena
concept_athlete_jorge_garbajosa	concept_stadiumoreventvenue_air_canada_center
concept_athlete_jose_calderon	concept_stadiumoreventvenue_air_canada_center
concept_athlete_jose_reyes	concept_stadiumoreventvenue_shea_stadium
concept_athlete_joseph_addai	concept_stadiumoreventvenue_lucas_oil_stadium
concept_athlete_josh_howard	concept_stadiumoreventvenue_american_airlines_center
concept_athlete_josh_smith	concept_stadiumoreventvenue_philips_arena
concept_athlete_julius_erving	concept_stadiumoreventvenue_izod_center
concept_athlete_junichi_tazawa	concept_stadiumoreventvenue_fenway
concept_athlete_junior_seau	concept_stadiumoreventvenue_qualcomm_stadium
concept_athlete_justin_fargas	concept_stadiumoreventvenue_mcafee_coliseum
concept_athlete_justin_tuck	concept_stadiumoreventvenue_giants_stadium
concept_athlete_justin_upton	concept_stadiumoreventvenue_chase_field
concept_athlete_kei_igawa	concept_stadiumoreventvenue_yankee_stadium
concept_athlete_keith_hernandez	concept_stadiumoreventvenue_shea_stadium
concept_athlete_kelly_johnson	concept_stadiumoreventvenue_turner_field
concept_athlete_ken_dorsey	concept_stadiumoreventvenue_cleveland_browns_stadium
concept_athlete_kendrick_perkins	concept_stadiumoreventvenue_td_garden
concept_athlete_kenji_johjima	concept_stadiumoreventvenue_safeco_field
concept_athlete_kevin_durant	concept_stadiumoreventvenue_key_arena
concept_athlete_kevin_mchale	concept_stadiumoreventvenue_td_garden
concept_athlete_kirilenko	concept_stadiumoreventvenue_energysolutions_arena
concept_athlete_kirk_gibson	concept_stadiumoreventvenue_dodger_stadium
concept_athlete_kirk_hinrich	concept_stadiumoreventvenue_united_center
concept_athlete_kirk_maltby	concept_stadiumoreventvenue_joe_louis_arena
concept_athlete_kris_benson	concept_stadiumoreventvenue_camden_yards
concept_athlete_kris_draper	concept_stadiumoreventvenue_joe_louis_arena
concept_athlete_kurt_warner	concept_stadiumoreventvenue_dome
concept_athlete_kwame_brown	concept_stadiumoreventvenue_staples_center
concept_athlete_kyle_orton	concept_stadiumoreventvenue_soldier_field
concept_athlete_ladell_betts	concept_stadiumoreventvenue_fedex_field
concept_athlete_lamar_odom	concept_stadiumoreventvenue_staples_center
concept_athlete_lamarcus_aldridge	concept_stadiumoreventvenue_rose_garden
concept_athlete_larry_foote	concept_stadiumoreventvenue_heinz_field
concept_athlete_larry_johnson	concept_stadiumoreventvenue_arrowhead_stadium
concept_athlete_lawrence_taylor	concept_stadiumoreventvenue_giants_stadium
concept_athlete_lebron	concept_stadiumoreventvenue_madison_square_garden
concept_athlete_lebron	concept_stadiumoreventvenue_quicken_loans_arena
concept_athlete_leon_powe	concept_stadiumoreventvenue_td_garden
concept_athlete_lidstrom	concept_stadiumoreventvenue_joe_louis_arena
concept_athlete_limas_sweed	concept_stadiumoreventvenue_heinz_field
concept_athlete_lindsey_hunter	concept_stadiumoreventvenue_palace_of_auburn_hills
concept_athlete_lionel_messi	concept_stadiumoreventvenue_camp_nou
concept_athlete_longoria	concept_stadiumoreventvenue_tropicana_field
concept_athlete_lorenzen_wright	concept_stadiumoreventvenue_great_american_ball_park
concept_athlete_lou_gehrig	concept_stadiumoreventvenue_yankee_stadium
concept_athlete_lou_piniella	concept_stadiumoreventvenue_wrigley_field
concept_athlete_ludovic_giuly	concept_stadiumoreventvenue_camp_nou
concept_athlete_luis_castillo	concept_stadiumoreventvenue_shea_stadium
concept_athlete_luis_figo	concept_stadiumoreventvenue_santiago_bernab
concept_athlete_luis_garcia	concept_stadiumoreventvenue_anfield
concept_athlete_luis_scola	concept_stadiumoreventvenue_toyota_center
concept_athlete_luke_scott	concept_stadiumoreventvenue_camden_yards
concept_athlete_luol_deng	concept_stadiumoreventvenue_united_center
concept_athlete_luther_head	concept_stadiumoreventvenue_toyota_center
concept_athlete_magic_johnson	concept_stadiumoreventvenue_staples_center
concept_athlete_marc_bulger	concept_stadiumoreventvenue_dome
concept_athlete_marc_gasol	concept_stadiumoreventvenue_fedex_forum
concept_athlete_marcus_camby	concept_stadiumoreventvenue_air_canada_center
concept_athlete_marcus_camby	concept_stadiumoreventvenue_staples_center
concept_athlete_marcus_spears	concept_stadiumoreventvenue_texas_stadium
concept_athlete_marcus_williams	concept_stadiumoreventvenue_izod_center
concept_athlete_mario_chalmers	concept_stadiumoreventvenue_american_airlines_arena
concept_athlete_mark_derosa	concept_stadiumoreventvenue_wrigley_field
concept_athlete_mark_grace	concept_stadiumoreventvenue_wrigley_field
concept_athlete_mark_hendrickson	concept_stadiumoreventvenue_dolphin_stadium
concept_athlete_mark_kotsay	concept_stadiumoreventvenue_turner_field
concept_athlete_mark_reynolds	concept_stadiumoreventvenue_chase_field
concept_athlete_mark_teixeira	concept_stadiumoreventvenue_yankee_stadium
concept_athlete_marquis_daniels	concept_stadiumoreventvenue_american_airlines_center
concept_athlete_marquis_daniels	concept_stadiumoreventvenue_conseco_fieldhouse
concept_athlete_martell_webster	concept_stadiumoreventvenue_rose_garden
concept_athlete_martin_brodeur	concept_stadiumoreventvenue_prudential_center_2
concept_athlete_martin_havlat	concept_stadiumoreventvenue_wrigley_field
concept_athlete_marty_turco	concept_stadiumoreventvenue_wrigley_field
concept_athlete_marvin_harrison	concept_stadiumoreventvenue_lucas_oil_stadium
concept_athlete_marvin_williams	concept_stadiumoreventvenue_philips_arena
concept_athlete_mathieu_schneider	concept_stadiumoreventvenue_honda_center
concept_athlete_matt_cain	concept_stadiumoreventvenue_giants_stadium
concept_athlete_matt_garza	concept_stadiumoreventvenue_tropicana_field
concept_athlete_matt_harpring	concept_stadiumoreventvenue_amway_arena
concept_athlete_matt_harpring	concept_stadiumoreventvenue_energysolutions_arena
concept_athlete_matt_hasselbeck	concept_stadiumoreventvenue_husky_stadium
concept_athlete_matt_murton	concept_stadiumoreventvenue_wrigley_field
concept_athlete_matt_ryan	concept_stadiumoreventvenue_georgia_dome
concept_athlete_mattias_weinhandl	concept_stadiumoreventvenue_nassau_coliseum
concept_athlete_maury_wills	concept_stadiumoreventvenue_dodger_stadium
concept_athlete_mehmet_okur	concept_stadiumoreventvenue_energysolutions_arena
concept_athlete_messi	concept_stadiumoreventvenue_camp_nou
concept_athlete_mewelde_moore	concept_stadiumoreventvenue_heinz_field
concept_athlete_michael_beasley	concept_stadiumoreventvenue_american_airlines_arena
concept_athlete_michael_doleac	concept_stadiumoreventvenue_amway_arena
concept_athlete_michael_ryder	concept_stadiumoreventvenue_td_garden
concept_athlete_michael_strahan	concept_stadiumoreventvenue_giants_stadium
concept_athlete_michael_vick	concept_stadiumoreventvenue_georgia_dome
concept_athlete_michel_goulet	concept_stadiumoreventvenue_wrigley_field
concept_athlete_mickey_cochrane	concept_stadiumoreventvenue_yankee_stadium
concept_athlete_miikka_kiprusoff	concept_stadiumoreventvenue_pengrowth_saddledome
concept_athlete_mike_bibby	concept_stadiumoreventvenue_philips_arena
concept_athlete_mike_dunleavy	concept_stadiumoreventvenue_conseco_fieldhouse
concept_athlete_mike_green	concept_stadiumoreventvenue_verizon_center
concept_athlete_mike_jacobs	concept_stadiumoreventvenue_dolphin_stadium
concept_athlete_mike_lowell	concept_stadiumoreventvenue_fenway
concept_athlete_mike_miller	concept_stadiumoreventvenue_fedex_forum
concept_athlete_mike_mussina	concept_stadiumoreventvenue_yankee_stadium
concept_athlete_mike_piazza	concept_stadiumoreventvenue_shea_stadium
concept_athlete_mike_singletary	concept_stadiumoreventvenue_soldier_field
concept_athlete_mike_smith	concept_stadiumoreventvenue_pete_times_forum
concept_athlete_milton_bradley	concept_stadiumoreventvenue_wrigley_field
concept_athlete_moises_alou	concept_stadiumoreventvenue_shea_stadium
concept_athlete_monta_ellis	concept_stadiumoreventvenue_oracle_arena
concept_athlete_morris_peterson	concept_stadiumoreventvenue_air_canada_center
concept_athlete_mussina	concept_stadiumoreventvenue_yankee_stadium
concept_athlete_nady	concept_stadiumoreventvenue_yankee_stadium
concept_athlete_najeh_davenport	concept_stadiumoreventvenue_heinz_field
concept_athlete_nani	concept_stadiumoreventvenue_old_trafford
concept_athlete_nick_markakis	concept_stadiumoreventvenue_camden_yards
concept_athlete_nick_punto	concept_stadiumoreventvenue_fenway
concept_athlete_nick_swisher	concept_stadiumoreventvenue_yankee_stadium
concept_athlete_nick_young	concept_stadiumoreventvenue_verizon_center
concept_athlete_nicklas_backstrom	concept_stadiumoreventvenue_verizon_center
concept_athlete_nicklas_lidstrom	concept_stadiumoreventvenue_joe_louis_arena
concept_athlete_niklas_backstrom	concept_stadiumoreventvenue_xcel_energy_center
concept_athlete_niklas_kronwall	concept_stadiumoreventvenue_joe_louis_arena
concept_athlete_nikolai_khabibulin	concept_stadiumoreventvenue_wrigley_field
concept_athlete_nolan_ryan	concept_stadiumoreventvenue_shea_stadium
concept_athlete_nomar_garciaparra	concept_stadiumoreventvenue_dodger_stadium
concept_athlete_o__j__simpson	concept_stadiumoreventvenue_fedex_forum
concept_athlete_oliver_perez	concept_stadiumoreventvenue_shea_stadium
concept_athlete_olmedo_saenz	concept_stadiumoreventvenue_dodger_stadium
concept_athlete_orel_hershiser	concept_stadiumoreventvenue_dodger_stadium
concept_athlete_orlando_cabrera	concept_stadiumoreventvenue_us_cellular_field
concept_athlete_oscar_villarreal	concept_stadiumoreventvenue_turner_field
concept_athlete_osi_umenyiora	concept_stadiumoreventvenue_giants_stadium
concept_athlete_ovechkin	concept_stadiumoreventvenue_verizon_center
concept_athlete_pacman_jones	concept_stadiumoreventvenue_texas_stadium
concept_athlete_pat_burrell	concept_stadiumoreventvenue_tropicana_field
concept_athlete_patrick_marleau	concept_stadiumoreventvenue_hp_pavilion
concept_athlete_patrick_sharp	concept_stadiumoreventvenue_wrigley_field
concept_athlete_pau_gasol	concept_stadiumoreventvenue_staples_center
concept_athlete_paul_konerko	concept_stadiumoreventvenue_us_cellular_field
concept_athlete_paul_lo_duca	concept_stadiumoreventvenue_shea_stadium
concept_athlete_paul_millsap	concept_stadiumoreventvenue_energysolutions_arena
concept_athlete_paul_pierce	concept_stadiumoreventvenue_td_garden
concept_athlete_paul_scholes	concept_stadiumoreventvenue_old_trafford
concept_athlete_pavel_datsyuk	concept_stadiumoreventvenue_joe_louis_arena
concept_athlete_pedroia	concept_stadiumoreventvenue_fenway
concept_athlete_pelfrey	concept_stadiumoreventvenue_shea_stadium
concept_athlete_peter_crouch	concept_stadiumoreventvenue_anfield
concept_athlete_petr_sykora	concept_stadiumoreventvenue_mellon_arena
concept_athlete_pettitte	concept_stadiumoreventvenue_yankee_stadium
concept_athlete_peyton_hillis	concept_stadiumoreventvenue_invesco_field
concept_athlete_peyton_manning	concept_stadiumoreventvenue_lucas_oil_stadium
concept_athlete_phil_coke	concept_stadiumoreventvenue_pete_times_forum
concept_athlete_phil_hughes_and_ian_kennedy	concept_stadiumoreventvenue_yankee_stadium
concept_athlete_phil_rizzuto	concept_stadiumoreventvenue_yankee_stadium
concept_athlete_phil_simms	concept_stadiumoreventvenue_giants_stadium
concept_athlete_pierre_pilote	concept_stadiumoreventvenue_wrigley_field
concept_athlete_plaxico	concept_stadiumoreventvenue_giants_stadium
concept_athlete_plaxico_burress	concept_stadiumoreventvenue_giants_stadium
concept_athlete_portis	concept_stadiumoreventvenue_fedex_field
concept_athlete_priest_holmes	concept_stadiumoreventvenue_arrowhead_stadium
concept_athlete_prince_fielder	concept_stadiumoreventvenue_miller_motorsports_park
concept_athlete_pujols	concept_stadiumoreventvenue_busch_memorial_stadium
concept_athlete_putz	concept_stadiumoreventvenue_shea_stadium
concept_athlete_quarterback_ben_roethlisberger	concept_stadiumoreventvenue_heinz_field
concept_athlete_quarterback_matt_ryan	concept_stadiumoreventvenue_georgia_dome
concept_athlete_rafael_furcal	concept_stadiumoreventvenue_dodger_stadium
concept_athlete_rafael_soriano	concept_stadiumoreventvenue_dodger_stadium
concept_athlete_rafer_alston	concept_stadiumoreventvenue_toyota_center
concept_athlete_rajai_davis	concept_stadiumoreventvenue_fenway
concept_athlete_rajon_rondo	concept_stadiumoreventvenue_td_garden
concept_athlete_ramirez	concept_stadiumoreventvenue_dodger_stadium
concept_athlete_ramirez	concept_stadiumoreventvenue_fenway
concept_athlete_ramon_castro	concept_stadiumoreventvenue_shea_stadium
concept_athlete_ramon_ramirez	concept_stadiumoreventvenue_fenway
concept_athlete_randy	concept_stadiumoreventvenue_mcafee_coliseum
concept_athlete_randy_foye	concept_stadiumoreventvenue_target_center
concept_athlete_randy_johnson	concept_stadiumoreventvenue_chase_field
concept_athlete_rashard_lewis	concept_stadiumoreventvenue_madison_square_garden
concept_athlete_rashard_mendenhall	concept_stadiumoreventvenue_heinz_field
concept_athlete_raul_ibanez	concept_stadiumoreventvenue_safeco_field
concept_athlete_ray_allen	concept_stadiumoreventvenue_bradley_center
concept_athlete_ray_allen	concept_stadiumoreventvenue_key_arena
concept_athlete_raymar_morgan	concept_stadiumoreventvenue_spartan_stadium
concept_athlete_reggie_wayne	concept_stadiumoreventvenue_lucas_oil_stadium
concept_athlete_reggie_white	concept_stadiumoreventvenue_pete_times_forum
concept_athlete_rene_bourque	concept_stadiumoreventvenue_wrigley_field
concept_athlete_renteria	concept_stadiumoreventvenue_turner_field
concept_athlete_rich_aurilia	concept_stadiumoreventvenue_giants_stadium
concept_athlete_rich_gannon	concept_stadiumoreventvenue_mcafee_coliseum
concept_athlete_rich_harden	concept_stadiumoreventvenue_wrigley_field
concept_athlete_rich_hill	concept_stadiumoreventvenue_wrigley_field
concept_athlete_rick_dipietro	concept_stadiumoreventvenue_nassau_coliseum
concept_athlete_rick_pitino	concept_stadiumoreventvenue_td_garden
concept_athlete_rickey_henderson	concept_stadiumoreventvenue_mcafee_coliseum
concept_athlete_rio_ferdinand	concept_stadiumoreventvenue_old_trafford
concept_athlete_rob_niedermayer	concept_stadiumoreventvenue_honda_center
concept_athlete_robert_horry	concept_stadiumoreventvenue_toyota_center
concept_athlete_roberto_alomar	concept_stadiumoreventvenue_shea_stadium
concept_athlete_roberto_luongo	concept_stadiumoreventvenue_rogers_arena
concept_athlete_robinson_cano	concept_stadiumoreventvenue_yankee_stadium
concept_athlete_rocco_baldelli	concept_stadiumoreventvenue_fenway
concept_athlete_rocco_baldelli	concept_stadiumoreventvenue_tropicana_field
concept_athlete_roddy_white	concept_stadiumoreventvenue_georgia_dome
concept_athlete_rodney_stuckey	concept_stadiumoreventvenue_palace_of_auburn_hills
concept_athlete_roethlisberger	concept_stadiumoreventvenue_heinz_field
concept_athlete_romo	concept_stadiumoreventvenue_texas_stadium
concept_athlete_ron_artest	concept_stadiumoreventvenue_united_center
concept_athlete_ron_villone	concept_stadiumoreventvenue_shea_stadium
concept_athlete_ronaldo	concept_stadiumoreventvenue_old_trafford
concept_athlete_ronnie_brewer	concept_stadiumoreventvenue_energysolutions_arena
concept_athlete_ronny_cedeno	concept_stadiumoreventvenue_wrigley_field
concept_athlete_ronny_turiaf	concept_stadiumoreventvenue_staples_center
concept_athlete_roy_halladay	concept_stadiumoreventvenue_rogers_centre
concept_athlete_roy_williams	concept_stadiumoreventvenue_texas_stadium
concept_athlete_rudi_johnson	concept_stadiumoreventvenue_great_american_ball_park
concept_athlete_rudy_gay	concept_stadiumoreventvenue_fedex_forum
concept_athlete_ruslan_fedotenko	concept_stadiumoreventvenue_nassau_coliseum
concept_athlete_ryan	concept_stadiumoreventvenue_georgia_dome
concept_athlete_ryan_babel	concept_stadiumoreventvenue_anfield
concept_athlete_ryan_carter	concept_stadiumoreventvenue_honda_center
concept_athlete_ryan_dempster	concept_stadiumoreventvenue_wrigley_field
concept_athlete_ryan_freel	concept_stadiumoreventvenue_great_american_ball_park
concept_athlete_ryan_getzlaf	concept_stadiumoreventvenue_honda_center
concept_athlete_ryan_giggs	concept_stadiumoreventvenue_old_trafford
concept_athlete_ryan_gomes	concept_stadiumoreventvenue_td_garden
concept_athlete_ryan_malone	concept_stadiumoreventvenue_mellon_arena
concept_athlete_ryan_theriot	concept_stadiumoreventvenue_wrigley_field
concept_athlete_samuel_eto_o	concept_stadiumoreventvenue_camp_nou
concept_athlete_sandy_koufax	concept_stadiumoreventvenue_dodger_stadium
concept_athlete_santonio_holmes	concept_stadiumoreventvenue_heinz_field
concept_athlete_scott_clemmensen	concept_stadiumoreventvenue_prudential_center_2
concept_athlete_scott_kazmir	concept_stadiumoreventvenue_pete_times_forum
concept_athlete_scott_niedermayer	concept_stadiumoreventvenue_honda_center
concept_athlete_scott_olsen	concept_stadiumoreventvenue_dolphin_stadium
concept_athlete_sean_williams	concept_stadiumoreventvenue_izod_center
concept_athlete_semin	concept_stadiumoreventvenue_verizon_center
concept_athlete_sergio_ramos	concept_stadiumoreventvenue_santiago_bernab
concept_athlete_shane_battier	concept_stadiumoreventvenue_fedex_forum
concept_athlete_shane_battier	concept_stadiumoreventvenue_toyota_center
concept_athlete_shaq	concept_stadiumoreventvenue_us_airways_center
concept_athlete_shaun_livingston	concept_stadiumoreventvenue_staples_center
concept_athlete_shawn_green	concept_stadiumoreventvenue_shea_stadium
concept_athlete_shawne_merriman	concept_stadiumoreventvenue_qualcomm_stadium
concept_athlete_shortstops_juan_uribe	concept_stadiumoreventvenue_camden_yards
concept_athlete_sidney_crosby	concept_stadiumoreventvenue_mellon_arena
concept_athlete_sidney_ponson	concept_stadiumoreventvenue_yankee_stadium
concept_athlete_smoltz	concept_stadiumoreventvenue_fenway
concept_athlete_stan_mikita	concept_stadiumoreventvenue_wrigley_field
concept_athlete_stephon_marbury	concept_stadiumoreventvenue_madison_square_garden
concept_athlete_stephon_marbury	concept_stadiumoreventvenue_target_center
concept_athlete_steve_blake	concept_stadiumoreventvenue_rose_garden
concept_athlete_steve_francis	concept_stadiumoreventvenue_toyota_center
concept_athlete_steve_nash	concept_stadiumoreventvenue_us_airways_center
concept_athlete_steve_smith	concept_stadiumoreventvenue_giants_stadium
concept_athlete_steve_trachsel	concept_stadiumoreventvenue_shea_stadium
concept_athlete_steve_yzerman	concept_stadiumoreventvenue_joe_louis_arena
concept_athlete_steven_gerrard	concept_stadiumoreventvenue_great_american_ball_park
concept_athlete_t__j__ford	concept_stadiumoreventvenue_bradley_center
concept_athlete_tatum_bell	concept_stadiumoreventvenue_invesco_field
concept_athlete_tayshaun_prince	concept_stadiumoreventvenue_palace_of_auburn_hills
concept_athlete_ted_thompson	concept_stadiumoreventvenue_pete_times_forum
concept_athlete_ted_williams	concept_stadiumoreventvenue_fenway
concept_athlete_teemu_selanne	concept_stadiumoreventvenue_honda_center
concept_athlete_teixeira	concept_stadiumoreventvenue_fenway
concept_athlete_terry_glenn	concept_stadiumoreventvenue_texas_stadium
concept_athlete_thabo_sefolosha	concept_stadiumoreventvenue_united_center
concept_athlete_thaddeus_young	concept_stadiumoreventvenue_wachovia_center
concept_athlete_thome	concept_stadiumoreventvenue_us_cellular_field
concept_athlete_tiki_barber	concept_stadiumoreventvenue_giants_stadium
concept_athlete_tim_dillard	concept_stadiumoreventvenue_yankee_stadium
concept_athlete_tim_hudson	concept_stadiumoreventvenue_turner_field
concept_athlete_tim_lincecum	concept_stadiumoreventvenue_giants_stadium
concept_athlete_tim_redding	concept_stadiumoreventvenue_shea_stadium
concept_athlete_tim_thomas	concept_stadiumoreventvenue_td_garden
concept_athlete_tim_thomas	concept_stadiumoreventvenue_wachovia_center
concept_athlete_tim_wakefield	concept_stadiumoreventvenue_fenway
concept_athlete_tom_glavine	concept_stadiumoreventvenue_shea_stadium
concept_athlete_tom_seaver	concept_stadiumoreventvenue_shea_stadium
concept_athlete_tomas_holmstrom	concept_stadiumoreventvenue_joe_louis_arena
concept_athlete_tomas_kopecky	concept_stadiumoreventvenue_wrigley_field
concept_athlete_tomlinson	concept_stadiumoreventvenue_qualcomm_stadium
concept_athlete_tommy_maddox	concept_stadiumoreventvenue_heinz_field
concept_athlete_tony_clark	concept_stadiumoreventvenue_chase_field
concept_athlete_tony_dorsett	concept_stadiumoreventvenue_texas_stadium
concept_athlete_tony_esposito	concept_stadiumoreventvenue_wrigley_field
concept_athlete_tony_gonzalez	concept_stadiumoreventvenue_arrowhead_stadium
concept_athlete_tony_romo	concept_stadiumoreventvenue_texas_stadium
concept_athlete_tracy_mcgrady	concept_stadiumoreventvenue_toyota_center
concept_athlete_travis_moen	concept_stadiumoreventvenue_honda_center
concept_athlete_travis_snider	concept_stadiumoreventvenue_rogers_centre
concept_athlete_travis_zajac	concept_stadiumoreventvenue_prudential_center_2
concept_athlete_trent_hunter	concept_stadiumoreventvenue_nassau_coliseum
concept_athlete_trot_nixon	concept_stadiumoreventvenue_fenway
concept_athlete_troy_brouwer	concept_stadiumoreventvenue_wrigley_field
concept_athlete_troy_polamalu	concept_stadiumoreventvenue_heinz_field
concept_athlete_tuukka_rask	concept_stadiumoreventvenue_td_garden
concept_athlete_ty_conklin	concept_stadiumoreventvenue_joe_louis_arena
concept_athlete_tyler_thigpen	concept_stadiumoreventvenue_arrowhead_stadium
concept_athlete_tyrus_thomas	concept_stadiumoreventvenue_izod_center
concept_athlete_tyrus_thomas	concept_stadiumoreventvenue_united_center
concept_athlete_udonis_haslem	concept_stadiumoreventvenue_american_airlines_arena
concept_athlete_urlacher	concept_stadiumoreventvenue_soldier_field
concept_athlete_valtteri_filppula	concept_stadiumoreventvenue_joe_louis_arena
concept_athlete_varitek	concept_stadiumoreventvenue_fenway
concept_athlete_vernon_wells	concept_stadiumoreventvenue_rogers_centre
concept_athlete_vinny_lecavalier	concept_stadiumoreventvenue_pete_times_forum
concept_athlete_vladimir_radmanovic	concept_stadiumoreventvenue_staples_center
concept_athlete_wade_boggs	concept_stadiumoreventvenue_yankee_stadium
concept_athlete_wallace	concept_stadiumoreventvenue_heinz_field
concept_athlete_wally_szczerbiak	concept_stadiumoreventvenue_target_center
concept_athlete_wally_szczerbiak	concept_stadiumoreventvenue_td_garden
concept_athlete_wayne_rooney	concept_stadiumoreventvenue_old_trafford
concept_athlete_willie_randolph	concept_stadiumoreventvenue_yankee_stadium
concept_athlete_willis	concept_stadiumoreventvenue_dolphin_stadium
concept_athlete_xabi	concept_stadiumoreventvenue_anfield
concept_athlete_xavi	concept_stadiumoreventvenue_camp_nou
concept_athlete_xavier_nady	concept_stadiumoreventvenue_yankee_stadium
concept_athlete_yi_jianlian	concept_stadiumoreventvenue_izod_center
concept_athlete_yunel_escobar	concept_stadiumoreventvenue_turner_field
concept_athlete_zach_parise	concept_stadiumoreventvenue_prudential_center_2
concept_athlete_zach_randolph	concept_stadiumoreventvenue_madison_square_garden
concept_athlete_zach_thomas	concept_stadiumoreventvenue_giants_stadium
concept_athlete_zaun	concept_stadiumoreventvenue_camden_yards
concept_athlete_zaza_pachulia	concept_stadiumoreventvenue_philips_arena
concept_celebrity_quentin_richardson	concept_stadiumoreventvenue_madison_square_garden
concept_coach_a_j__burnett	concept_stadiumoreventvenue_rogers_centre
concept_coach_a_j__hawk	concept_stadiumoreventvenue_us_cellular_field
concept_coach_aaron_harang	concept_stadiumoreventvenue_wrigley_field
concept_coach_adam_laroche	concept_stadiumoreventvenue_turner_field
concept_coach_adrian_peterson	concept_stadiumoreventvenue_metrodome
concept_coach_al_harrington	concept_stadiumoreventvenue_madison_square_garden
concept_coach_al_harrington	concept_stadiumoreventvenue_philips_arena
concept_coach_al_jefferson	concept_stadiumoreventvenue_palace_of_auburn_hills
concept_coach_al_jefferson	concept_stadiumoreventvenue_verizon_center
concept_coach_al_wilson	concept_stadiumoreventvenue_invesco_field
concept_coach_alexei_yashin	concept_stadiumoreventvenue_nassau_coliseum
concept_coach_andre_ethier	concept_stadiumoreventvenue_dodger_stadium
concept_coach_andrew_brunette	concept_stadiumoreventvenue_wrigley_field
concept_coach_andrew_ladd	concept_stadiumoreventvenue_wrigley_field
concept_coach_andy_mcdonald	concept_stadiumoreventvenue_honda_center
concept_coach_andy_pettite	concept_stadiumoreventvenue_yankee_stadium
concept_coach_bill_romanowski	concept_stadiumoreventvenue_invesco_field
concept_coach_blake_comeau	concept_stadiumoreventvenue_nassau_coliseum
concept_coach_bob_sanders	concept_stadiumoreventvenue_lucas_oil_stadium
concept_coach_bobby_jackson	concept_stadiumoreventvenue_conseco_fieldhouse
concept_coach_bobby_ryan	concept_stadiumoreventvenue_honda_center
concept_coach_brad_thompson	concept_stadiumoreventvenue_pete_times_forum
concept_coach_brady_quinn	concept_stadiumoreventvenue_cleveland_browns_stadium
concept_coach_brandon_braboy	concept_stadiumoreventvenue_cleveland_browns_stadium
concept_coach_brandon_braboy	concept_stadiumoreventvenue_quicken_loans_arena
concept_coach_brendan_shanahan	concept_stadiumoreventvenue_prudential_center_2
concept_coach_brian_rolston	concept_stadiumoreventvenue_prudential_center_2
concept_coach_brooks_orpik	concept_stadiumoreventvenue_mellon_arena
concept_coach_cal_ripken	concept_stadiumoreventvenue_camden_yards
concept_coach_carlos_marmol	concept_stadiumoreventvenue_shea_stadium
concept_coach_chad_larose	concept_stadiumoreventvenue_bank_atlantic_center
concept_coach_chad_pennington	concept_stadiumoreventvenue_dolphins_stadium
concept_coach_chad_pennington	concept_stadiumoreventvenue_giants_stadium
concept_coach_chris_johnson	concept_stadiumoreventvenue_lp_field
concept_coach_chris_paul	concept_stadiumoreventvenue_new_orleans_arena
concept_coach_chris_simon	concept_stadiumoreventvenue_nassau_coliseum
concept_coach_chris_volstad	concept_stadiumoreventvenue_dolphin_stadium
concept_coach_clinton_portis	concept_stadiumoreventvenue_fedex_field
concept_coach_colt_brennan	concept_stadiumoreventvenue_fedex_field
concept_coach_dany_sabourin	concept_stadiumoreventvenue_mellon_arena
concept_coach_daunte_culpepper	concept_stadiumoreventvenue_metrodome
concept_coach_dave_winfield	concept_stadiumoreventvenue_yankee_stadium
concept_coach_david_clarkson	concept_stadiumoreventvenue_prudential_center_2
concept_coach_deangelo_hall	concept_stadiumoreventvenue_mcafee_coliseum
concept_coach_derrek_lee	concept_stadiumoreventvenue_wrigley_field
concept_coach_derrick_rose	concept_stadiumoreventvenue_madison_square_garden
concept_coach_derrick_ward	concept_stadiumoreventvenue_giants_stadium
concept_coach_devin_thomas	concept_stadiumoreventvenue_fedex_field
concept_coach_doug_weight	concept_stadiumoreventvenue_nassau_coliseum
concept_coach_dustin_mcgowan	concept_stadiumoreventvenue_rogers_centre
concept_coach_dwayne_wade	concept_stadiumoreventvenue_american_airlines_arena
concept_coach_eddie_royal	concept_stadiumoreventvenue_invesco_field
concept_coach_evgeni_malkin	concept_stadiumoreventvenue_mellon_arena
concept_coach_evgeni_nabokov	concept_stadiumoreventvenue_hp_pavilion
concept_coach_frank_robinson	concept_stadiumoreventvenue_td_garden
concept_coach_frans_nielsen	concept_stadiumoreventvenue_nassau_coliseum
concept_coach_fred_lynn	concept_stadiumoreventvenue_fenway
concept_coach_freddy_meyer	concept_stadiumoreventvenue_nassau_coliseum
concept_coach_gale_sayers	concept_stadiumoreventvenue_soldier_field
concept_coach_garrett_wilson	concept_stadiumoreventvenue_verizon_center
concept_coach_gary_matthews_jr_	concept_stadiumoreventvenue_edison_field
concept_coach_george_parros	concept_stadiumoreventvenue_honda_center
concept_coach_ilya_kovalchuk	concept_stadiumoreventvenue_philips_arena
concept_coach_jake_plummer	concept_stadiumoreventvenue_invesco_field
concept_coach_jamal_mayers	concept_stadiumoreventvenue_wrigley_field
concept_coach_jamarcus_russell	concept_stadiumoreventvenue_mcafee_coliseum
concept_coach_jarkko_ruutu	concept_stadiumoreventvenue_mellon_arena
concept_coach_jason_bay	concept_stadiumoreventvenue_fenway
concept_coach_jason_campbell	concept_stadiumoreventvenue_fedex_field
concept_coach_jason_williams	concept_stadiumoreventvenue_arco_arena
concept_coach_jay_bruce	concept_stadiumoreventvenue_great_american_ball_park
concept_coach_jay_feely	concept_stadiumoreventvenue_giants_stadium
concept_coach_jean_sebastien_giguere	concept_stadiumoreventvenue_honda_center
concept_coach_jeremy_sowers	concept_stadiumoreventvenue_yankee_stadium
concept_coach_jerious_norwood	concept_stadiumoreventvenue_georgia_dome
concept_coach_jim_lonborg	concept_stadiumoreventvenue_fenway
concept_coach_jocelyn_thibault	concept_stadiumoreventvenue_wrigley_field
concept_coach_joe_tinker	concept_stadiumoreventvenue_wrigley_field
concept_coach_joe_torre	concept_stadiumoreventvenue_dodger_stadium
concept_coach_john_curry	concept_stadiumoreventvenue_mellon_arena
concept_coach_john_maine	concept_stadiumoreventvenue_shea_stadium
concept_coach_john_mcgraw	concept_stadiumoreventvenue_giants_stadium
concept_coach_johnny_damon	concept_stadiumoreventvenue_yankee_stadium
concept_coach_josef_vasicek	concept_stadiumoreventvenue_nassau_coliseum
concept_coach_josh_hamilton	concept_stadiumoreventvenue_ameriquest_field
concept_coach_josh_hamilton	concept_stadiumoreventvenue_yankee_stadium
concept_coach_kenny_rogers	concept_stadiumoreventvenue_comerica
concept_coach_kerry_collins	concept_stadiumoreventvenue_lp_field
concept_coach_kevin_youkilis	concept_stadiumoreventvenue_fenway
concept_coach_kris_letang	concept_stadiumoreventvenue_mellon_arena
concept_coach_kyle_okposo	concept_stadiumoreventvenue_nassau_coliseum
concept_coach_ladainian_tomlinson	concept_stadiumoreventvenue_qualcomm_stadium
concept_coach_lamarr_woodley	concept_stadiumoreventvenue_heinz_field
concept_coach_lance_briggs	concept_stadiumoreventvenue_soldier_field
concept_coach_laveranues_coles	concept_stadiumoreventvenue_giants_stadium
concept_coach_lawrence_tynes	concept_stadiumoreventvenue_giants_stadium
concept_coach_lebron_james	concept_stadiumoreventvenue_quicken_loans_arena
concept_coach_lendale_white	concept_stadiumoreventvenue_lp_field
concept_coach_lenny_moore	concept_stadiumoreventvenue_heinz_field
concept_coach_luke_hudson	concept_stadiumoreventvenue_yankee_stadium
concept_coach_marc_andre_fleury	concept_stadiumoreventvenue_mellon_arena
concept_coach_marion_barber_iii	concept_stadiumoreventvenue_texas_stadium
concept_coach_mark_parrish	concept_stadiumoreventvenue_nassau_coliseum
concept_coach_mark_recchi	concept_stadiumoreventvenue_pete_times_forum
concept_coach_mark_streit	concept_stadiumoreventvenue_nassau_coliseum
concept_coach_marshall_faulk	concept_stadiumoreventvenue_dome
concept_coach_matt_forte	concept_stadiumoreventvenue_soldier_field
concept_coach_matt_stairs	concept_stadiumoreventvenue_rogers_centre
concept_coach_matthew_lombardi	concept_stadiumoreventvenue_pengrowth_saddledome
concept_coach_michael_nylander	concept_stadiumoreventvenue_verizon_center
concept_coach_mickey_mantle	concept_stadiumoreventvenue_yankee_stadium
concept_coach_mike_comrie	concept_stadiumoreventvenue_nassau_coliseum
concept_coach_mike_fontenot	concept_stadiumoreventvenue_wrigley_field
concept_coach_mike_sillinger	concept_stadiumoreventvenue_nassau_coliseum
concept_coach_milan_hejduk	concept_stadiumoreventvenue_pepsi_center
concept_coach_nnamdi_asomugha	concept_stadiumoreventvenue_mcafee_coliseum
concept_coach_olaf_kolzig	concept_stadiumoreventvenue_pete_times_forum
concept_coach_patrick_kane	concept_stadiumoreventvenue_wrigley_field
concept_coach_patrik_elias	concept_stadiumoreventvenue_prudential_center_2
concept_coach_paul_martin	concept_stadiumoreventvenue_prudential_center_2
concept_coach_pedro_martinez	concept_stadiumoreventvenue_shea_stadium
concept_coach_peter_moylan	concept_stadiumoreventvenue_td_garden
concept_coach_philip_rivers	concept_stadiumoreventvenue_qualcomm_stadium
concept_coach_randor_bierd	concept_stadiumoreventvenue_camden_yards
concept_coach_rex_grossman	concept_stadiumoreventvenue_soldier_field
concept_coach_richard_hamilton	concept_stadiumoreventvenue_palace_of_auburn_hills
concept_coach_robyn_regehr	concept_stadiumoreventvenue_pengrowth_saddledome
concept_coach_roger_staubach	concept_stadiumoreventvenue_texas_stadium
concept_coach_ryan_fitzpatrick	concept_stadiumoreventvenue_great_american_ball_park
concept_coach_sammy_sosa	concept_stadiumoreventvenue_wrigley_field
concept_coach_seneca_wallace	concept_stadiumoreventvenue_husky_stadium
concept_coach_sergei_fedorov	concept_stadiumoreventvenue_verizon_center
concept_coach_sergei_gonchar	concept_stadiumoreventvenue_mellon_arena
concept_coach_shaun_alexander	concept_stadiumoreventvenue_husky_stadium
concept_coach_shea_weber	concept_stadiumoreventvenue_bridgestone_arena
concept_coach_sidney_crosby_and_evgeni_malkin	concept_stadiumoreventvenue_mellon_arena
concept_coach_steve_mcnair	concept_stadiumoreventvenue_lp_field
concept_coach_steve_montador	concept_stadiumoreventvenue_wrigley_field
concept_coach_steven_jackson	concept_stadiumoreventvenue_dome
concept_coach_steven_stamkos	concept_stadiumoreventvenue_pete_times_forum
concept_coach_tarvaris_jackson	concept_stadiumoreventvenue_metrodome
concept_coach_tim_jackman	concept_stadiumoreventvenue_nassau_coliseum
concept_coach_trent_edwards	concept_stadiumoreventvenue_ralph_wilson_stadium
concept_coach_tyler_kennedy	concept_stadiumoreventvenue_mellon_arena
concept_coach_vince_carter	concept_stadiumoreventvenue_amway_arena
concept_coach_vince_carter	concept_stadiumoreventvenue_izod_center
concept_coach_vince_young	concept_stadiumoreventvenue_lp_field
concept_coach_vincent_lecavalier	concept_stadiumoreventvenue_pete_times_forum
concept_coach_wade_dubielewicz	concept_stadiumoreventvenue_nassau_coliseum
concept_coach_warrick_dunn	concept_stadiumoreventvenue_georgia_dome
concept_coach_wojtek_wolski	concept_stadiumoreventvenue_pepsi_center
concept_male_alex_rodriguez	concept_stadiumoreventvenue_yankee_stadium
concept_male_allen_iverson	concept_stadiumoreventvenue_palace_of_auburn_hills
concept_male_daniel_ewing	concept_stadiumoreventvenue_air_canada_center
concept_male_darryl_strawberry	concept_stadiumoreventvenue_shea_stadium
concept_male_gerald_green	concept_stadiumoreventvenue_united_center
concept_male_jermaine_dye	concept_stadiumoreventvenue_us_cellular_field
concept_male_joakim_noah	concept_stadiumoreventvenue_united_center
concept_male_kevin_garnett	concept_stadiumoreventvenue_target_center
concept_male_richard_jefferson	concept_stadiumoreventvenue_arrowhead_stadium
concept_male_richard_jefferson	concept_stadiumoreventvenue_dome
concept_male_steve_garvey	concept_stadiumoreventvenue_dodger_stadium
concept_male_yogi_berra	concept_stadiumoreventvenue_yankee_stadium
concept_personafrica_brian_mccann	concept_stadiumoreventvenue_turner_field
concept_personasia_andre_miller	concept_stadiumoreventvenue_quicken_loans_arena
concept_personasia_chien_ming_wang	concept_stadiumoreventvenue_yankee_stadium
concept_personasia_rick_ankiel	concept_stadiumoreventvenue_busch_memorial_stadium
concept_personaustralia_arjen_robben	concept_stadiumoreventvenue_santiago_bernab
concept_personaustralia_brian_mcbride	concept_stadiumoreventvenue_toyota_park
concept_personaustralia_gary_neville	concept_stadiumoreventvenue_old_trafford
concept_personaustralia_joe_johnson	concept_stadiumoreventvenue_philips_arena
concept_personaustralia_john_danks	concept_stadiumoreventvenue_us_cellular_field
concept_personaustralia_josh_johnson	concept_stadiumoreventvenue_dolphin_stadium
concept_personaustralia_michael_owen	concept_stadiumoreventvenue_anfield
concept_personaustralia_ruud_van_nistelrooy	concept_stadiumoreventvenue_santiago_bernab
concept_personeurope_david_beckham	concept_stadiumoreventvenue_old_trafford
concept_personeurope_fernando_torres	concept_stadiumoreventvenue_anfield
concept_personeurope_marian_hossa	concept_stadiumoreventvenue_joe_louis_arena
concept_personeurope_owen_hargreaves	concept_stadiumoreventvenue_old_trafford
concept_personeurope_robbie_fowler	concept_stadiumoreventvenue_anfield
concept_personmexico_adam_dunn	concept_stadiumoreventvenue_chase_field
concept_personmexico_alexander_ovechkin	concept_stadiumoreventvenue_verizon_center
concept_personmexico_alfonso_soriano	concept_stadiumoreventvenue_wrigley_field
concept_personmexico_anthony_reyes001	concept_stadiumoreventvenue_great_american_ball_park
concept_personmexico_bobby_murcer	concept_stadiumoreventvenue_yankee_stadium
concept_personmexico_brandon_jacobs	concept_stadiumoreventvenue_giants_stadium
concept_personmexico_brendan_harris	concept_stadiumoreventvenue_yankee_stadium
concept_personmexico_brian_brohm	concept_stadiumoreventvenue_pete_times_forum
concept_personmexico_carlos_santana001	concept_stadiumoreventvenue_yankee_stadium
concept_personmexico_chris_chambers	concept_stadiumoreventvenue_qualcomm_stadium
concept_personmexico_cody_ross	concept_stadiumoreventvenue_dolphin_stadium
concept_personmexico_craig_counsell	concept_stadiumoreventvenue_yankee_stadium
concept_personmexico_daisuke_matsuzaka	concept_stadiumoreventvenue_fenway
concept_personmexico_daniel_carcillo	concept_stadiumoreventvenue_wrigley_field
concept_personmexico_david_tyree	concept_stadiumoreventvenue_giants_stadium
concept_personmexico_david_wright	concept_stadiumoreventvenue_shea_stadium
concept_personmexico_edinson_volquez	concept_stadiumoreventvenue_great_american_ball_park
concept_personmexico_felix_jones	concept_stadiumoreventvenue_texas_stadium
concept_personmexico_francisco_rodr_guez	concept_stadiumoreventvenue_shea_stadium
concept_personmexico_gregg_zaun	concept_stadiumoreventvenue_camden_yards
concept_personmexico_hideki_matsui	concept_stadiumoreventvenue_yankee_stadium
concept_personmexico_jamaal_anderson001	concept_stadiumoreventvenue_georgia_dome
concept_personmexico_jamal_lewis	concept_stadiumoreventvenue_cleveland_browns_stadium
concept_personmexico_jamie_langenbrunner	concept_stadiumoreventvenue_prudential_center_2
concept_personmexico_jason_bartlett	concept_stadiumoreventvenue_tropicana_field
concept_personmexico_jason_giambi	concept_stadiumoreventvenue_yankee_stadium
concept_personmexico_jason_taylor	concept_stadiumoreventvenue_fedex_field
concept_personmexico_jon_rauch	concept_stadiumoreventvenue_us_cellular_field
concept_personmexico_jonathan_van_every	concept_stadiumoreventvenue_fenway
concept_personmexico_jonathan_vilma	concept_stadiumoreventvenue_giants_stadium
concept_personmexico_jorge_posada	concept_stadiumoreventvenue_yankee_stadium
concept_personmexico_jose_castillo	concept_stadiumoreventvenue_giants_stadium
concept_personmexico_jose_molina	concept_stadiumoreventvenue_yankee_stadium
concept_personmexico_josh_beckett	concept_stadiumoreventvenue_fenway
concept_personmexico_josh_willingham	concept_stadiumoreventvenue_dolphin_stadium
concept_personmexico_juan_pie	concept_stadiumoreventvenue_dolphin_stadium
concept_personmexico_juan_pie	concept_stadiumoreventvenue_us_cellular_field
concept_personmexico_julio_franco	concept_stadiumoreventvenue_fenway
concept_personmexico_julius_jones	concept_stadiumoreventvenue_husky_stadium
concept_personmexico_lastings_milledge	concept_stadiumoreventvenue_shea_stadium
concept_personmexico_luis_gonzalez	concept_stadiumoreventvenue_chase_field
concept_personmexico_luke_walton	concept_stadiumoreventvenue_staples_center
concept_personmexico_lynn_swann	concept_stadiumoreventvenue_heinz_field
concept_personmexico_manny_ramirez	concept_stadiumoreventvenue_dodger_stadium
concept_personmexico_matt_diaz	concept_stadiumoreventvenue_turner_field
concept_personmexico_matt_flynn001	concept_stadiumoreventvenue_tropicana_field
concept_personmexico_matt_kemp	concept_stadiumoreventvenue_dodger_stadium
concept_personmexico_melky_cabrera	concept_stadiumoreventvenue_yankee_stadium
concept_personmexico_miguel_cabrera	concept_stadiumoreventvenue_dolphin_stadium
concept_personmexico_mookie_wilson	concept_stadiumoreventvenue_shea_stadium
concept_personmexico_patrick_roy	concept_stadiumoreventvenue_pepsi_center
concept_personmexico_ryan_church	concept_stadiumoreventvenue_shea_stadium
concept_personmexico_scott_thorman	concept_stadiumoreventvenue_turner_field
concept_personmexico_sean_marshall	concept_stadiumoreventvenue_camden_yards
concept_personmexico_shaun_marcum	concept_stadiumoreventvenue_rogers_centre
concept_personmexico_shaun_marcum	concept_stadiumoreventvenue_staples_center
concept_personmexico_todd_coffey	concept_stadiumoreventvenue_coors_field
concept_personmexico_tommie_agee	concept_stadiumoreventvenue_shea_stadium
concept_personmexico_vladimir_guerrero	concept_stadiumoreventvenue_edison_field
concept_personnorthamerica_michael_turner	concept_stadiumoreventvenue_georgia_dome
concept_personsouthamerica_ronaldinho	concept_stadiumoreventvenue_camp_nou
concept_personus_jackie_robinson	concept_stadiumoreventvenue_ebbets_field
concept_personus_jeremy_shockey	concept_stadiumoreventvenue_giants_stadium
concept_personus_kobe_bryant	concept_stadiumoreventvenue_staples_center
concept_personus_lance_berkman	concept_stadiumoreventvenue_minute_maid_park
concept_personus_orlando_hudson	concept_stadiumoreventvenue_chase_field
