concept_athlete_a_j__feeley	concept_sport_baseball
concept_athlete_aaron_kampman	concept_sport_football
concept_athlete_aaron_williams	concept_sport_basketball
concept_athlete_abreu	concept_sport_baseball
concept_athlete_adam_burish	concept_sport_hockey
concept_athlete_adam_jones	concept_sport_baseball
concept_athlete_adam_loewen	concept_sport_baseball
concept_athlete_adam_morrison	concept_sport_baseball
concept_athlete_adam_morrison	concept_sport_basketball
concept_athlete_adam_russell	concept_sport_baseball
concept_athlete_adrian_aucoin	concept_sport_hockey
concept_athlete_adrian_beltre	concept_sport_baseball
concept_athlete_adrian_griffin	concept_sport_basketball
concept_athlete_ahmad_bradshaw	concept_sport_football
concept_athlete_ahman_green	concept_sport_hockey
concept_athlete_akinori_iwamura	concept_sport_hockey
concept_athlete_albert_pujols	concept_sport_baseball
concept_athlete_alberto_gilardino	concept_sport_golf
concept_athlete_ales_hemsky	concept_sport_hockey
concept_athlete_ales_kotalik	concept_sport_hockey
concept_athlete_alex_burrows	concept_sport_hockey
concept_athlete_alex_kovalev	concept_sport_hockey
concept_athlete_alex_ovechkin	concept_sport_hockey
concept_athlete_alex_rios	concept_sport_baseball
concept_athlete_alexander_semin	concept_sport_hockey
concept_athlete_alexei_kovalev	concept_sport_hockey
concept_athlete_alexei_ponikarovsky	concept_sport_hockey
concept_athlete_alexei_ramirez	concept_sport_baseball
concept_athlete_allan_houston	concept_sport_basketball
concept_athlete_amani_toomer	concept_sport_football
concept_athlete_amare_stoudemire	concept_sport_basketball
concept_athlete_andray_blatche	concept_sport_basketball
concept_athlete_andre_brown	concept_sport_basketball
concept_athlete_andrea_bargnani	concept_sport_basketball
concept_athlete_andrei_kirilenko	concept_sport_basketball
concept_athlete_andres_nocioni	concept_sport_basketball
concept_athlete_andrew_bogut	concept_sport_basketball
concept_athlete_andrew_cogliano	concept_sport_hockey
concept_athlete_andrew_peters	concept_sport_hockey
concept_athlete_andrew_shaw	concept_sport_hockey
concept_athlete_andruw_jones	concept_sport_baseball
concept_athlete_andy_ritchie	concept_sport_baseball
concept_athlete_andy_sonnanstine	concept_sport_hockey
concept_athlete_antawn_jamison	concept_sport_basketball
concept_athlete_anthony_parker	concept_sport_basketball
concept_athlete_antonio_daniels	concept_sport_basketball
concept_athlete_antonio_mcdyess	concept_sport_basketball
concept_athlete_antonio_pierce	concept_sport_football
concept_athlete_aramis_ramirez	concept_sport_baseball
concept_athlete_ariza	concept_sport_basketball
concept_athlete_art_monk	concept_sport_football
concept_athlete_asante_samuel	concept_sport_baseball
concept_athlete_b_j__surhoff	concept_sport_baseball
concept_athlete_b_j__upton	concept_sport_football
concept_athlete_babe_ruth	concept_sport_baseball
concept_athlete_baldelli	concept_sport_baseball
concept_athlete_baron_davis	concept_sport_basketball
concept_athlete_barry_bonds	concept_sport_football
concept_athlete_barry_sanders	concept_sport_football
concept_athlete_battier	concept_sport_basketball
concept_athlete_bauer	concept_sport_baseball
concept_athlete_beltran	concept_sport_baseball
concept_athlete_ben_eager	concept_sport_hockey
concept_athlete_bernard_berrian	concept_sport_football
concept_athlete_bernie_kosar	concept_sport_football
concept_athlete_bernie_williams	concept_sport_baseball
concept_athlete_bibby	concept_sport_basketball
concept_athlete_big_ben	concept_sport_football
concept_athlete_bill_dickey	concept_sport_baseball
concept_athlete_bill_hall	concept_sport_baseball
concept_athlete_billy_wagner	concept_sport_baseball
concept_athlete_blair_betts	concept_sport_football
concept_athlete_blake	concept_sport_baseball
concept_athlete_bobby_hull	concept_sport_hockey
concept_athlete_bobby_orr	concept_sport_hockey
concept_athlete_bonds	concept_sport_football
concept_athlete_bonds	concept_sport_hockey
concept_athlete_boozer	concept_sport_basketball
concept_athlete_bosh	concept_sport_basketball
concept_athlete_brad_ausmus_gg	concept_sport_baseball
concept_athlete_brad_johnson	concept_sport_football
concept_athlete_brad_miller	concept_sport_hockey
concept_athlete_brad_penny	concept_sport_baseball
concept_athlete_brandan_wright	concept_sport_basketball
concept_athlete_branden_ore	concept_sport_football
concept_athlete_brandon_marshall	concept_sport_football
concept_athlete_brandon_marshall	concept_sport_hockey
concept_athlete_brandon_webb	concept_sport_baseball
concept_athlete_brendan_morrison	concept_sport_hockey
concept_athlete_brent_barry	concept_sport_basketball
concept_athlete_brent_johnson	concept_sport_hockey
concept_athlete_brent_seabrook	concept_sport_hockey
concept_athlete_brent_sopel	concept_sport_hockey
concept_athlete_brett_farve	concept_sport_football
concept_athlete_brett_gardner	concept_sport_baseball
concept_athlete_brevin_knight	concept_sport_basketball
concept_athlete_brian_campbell	concept_sport_hockey
concept_athlete_brian_elliott	concept_sport_hockey
concept_athlete_brian_gionta	concept_sport_hockey
concept_athlete_brian_griese	concept_sport_football
concept_athlete_brian_moehler	concept_sport_baseball
concept_athlete_brian_rafalski	concept_sport_hockey
concept_athlete_brian_roberts	concept_sport_baseball
concept_athlete_brian_schneider	concept_sport_baseball
concept_athlete_brian_westbrook	concept_sport_baseball
concept_athlete_brian_wilson	concept_sport_football
concept_athlete_brodeur	concept_sport_hockey
concept_athlete_brodie_croyle	concept_sport_football
concept_athlete_brooks_laich	concept_sport_hockey
concept_athlete_bruce_gradkowski	concept_sport_football
concept_athlete_bryan_mccabe	concept_sport_hockey
concept_athlete_bryan_robson	concept_sport_basketball
concept_athlete_bryzgalov	concept_sport_hockey
concept_athlete_bud_harrelson	concept_sport_baseball
concept_athlete_bulger	concept_sport_football
concept_athlete_burrell	concept_sport_hockey
concept_athlete_byron_leftwich	concept_sport_football
concept_athlete_cam_ward	concept_sport_hockey
concept_athlete_carey_price	concept_sport_hockey
concept_athlete_carl_crawford	concept_sport_baseball
concept_athlete_carl_landry	concept_sport_basketball
concept_athlete_carl_pavano	concept_sport_baseball
concept_athlete_carl_yastrzemski	concept_sport_baseball
concept_athlete_carlos_beltran	concept_sport_baseball
concept_athlete_carlos_boozer	concept_sport_basketball
concept_athlete_carlos_pena	concept_sport_hockey
concept_athlete_carlos_tevez	concept_sport_basketball
concept_athlete_carlos_zambrano	concept_sport_baseball
concept_athlete_carmelo_anthony	concept_sport_basketball
concept_athlete_carson_palmer	concept_sport_baseball
concept_athlete_casey_blake	concept_sport_baseball
concept_athlete_casey_stengel	concept_sport_baseball
concept_athlete_cc_sabathia	concept_sport_baseball
concept_athlete_cedric_benson	concept_sport_football
concept_athlete_chad_billingsley	concept_sport_baseball
concept_athlete_chad_hutchinson	concept_sport_football
concept_athlete_chad_johnson	concept_sport_baseball
concept_athlete_champ_bailey	concept_sport_football
concept_athlete_champ_bailey	concept_sport_hockey
concept_athlete_chan_ho_park	concept_sport_football
concept_athlete_charles_barkley	concept_sport_basketball
concept_athlete_charles_scott	concept_sport_golf
concept_athlete_charlie_bell	concept_sport_basketball
concept_athlete_charlie_frye	concept_sport_football
concept_athlete_charlie_villanueva	concept_sport_basketball
concept_athlete_chase_utley	concept_sport_baseball
concept_athlete_chauncey_billups	concept_sport_basketball
concept_athlete_chelios	concept_sport_hockey
concept_athlete_chipper_jones	concept_sport_baseball
concept_athlete_chris_bosh	concept_sport_basketball
concept_athlete_chris_chelios	concept_sport_hockey
concept_athlete_chris_cooley	concept_sport_football
concept_athlete_chris_davis	concept_sport_hockey
concept_athlete_chris_drury	concept_sport_hockey
concept_athlete_chris_duhon	concept_sport_basketball
concept_athlete_chris_kunitz	concept_sport_hockey
concept_athlete_chris_mason	concept_sport_hockey
concept_athlete_chris_mihm	concept_sport_basketball
concept_athlete_chris_osgood	concept_sport_hockey
concept_athlete_chris_pronger	concept_sport_hockey
concept_athlete_chris_redman	concept_sport_football
concept_athlete_chris_snyder	concept_sport_baseball
concept_athlete_chris_webber	concept_sport_basketball
concept_athlete_chris_young	concept_sport_baseball
concept_athlete_chuck_james	concept_sport_baseball
concept_athlete_chucky_atkins	concept_sport_basketball
concept_athlete_clay_buchholz	concept_sport_baseball
concept_athlete_clayton_kershaw	concept_sport_baseball
concept_athlete_clemens	concept_sport_baseball
concept_athlete_cleon_jones	concept_sport_baseball
concept_athlete_cliff_floyd	concept_sport_hockey
concept_athlete_cliff_lee	concept_sport_baseball
concept_athlete_clyde_drexler	concept_sport_basketball
concept_athlete_coco_crisp	concept_sport_baseball
concept_athlete_coco_crisp_	concept_sport_baseball
concept_athlete_cole_hamels	concept_sport_baseball
concept_athlete_colin_long	concept_sport_basketball
concept_athlete_colt_mccoy	concept_sport_golf
concept_athlete_colton_orr	concept_sport_hockey
concept_athlete_conor_jackson	concept_sport_baseball
concept_athlete_corey_hart	concept_sport_baseball
concept_athlete_corey_maggette	concept_sport_basketball
concept_athlete_corey_perry	concept_sport_hockey
concept_athlete_corey_webster	concept_sport_football
concept_athlete_correll_buckhalter	concept_sport_baseball
concept_athlete_craig_anderson	concept_sport_hockey
concept_athlete_craig_biggio	concept_sport_baseball
concept_athlete_craig_conroy	concept_sport_hockey
concept_athlete_craig_monroe	concept_sport_baseball
concept_athlete_crede	concept_sport_football
concept_athlete_cristiano_ronaldo	concept_sport_basketball
concept_athlete_cristobal_huet	concept_sport_hockey
concept_athlete_crosby	concept_sport_hockey
concept_athlete_curt_schilling	concept_sport_baseball
concept_athlete_curtis_martin	concept_sport_football
concept_athlete_cuttino_mobley	concept_sport_basketball
concept_athlete_d_j__augustin	concept_sport_basketball
concept_athlete_daequan_cook	concept_sport_basketball
concept_athlete_damon	concept_sport_baseball
concept_athlete_dan_boyle	concept_sport_hockey
concept_athlete_dan_carcillo	concept_sport_hockey
concept_athlete_dan_cleary	concept_sport_hockey
concept_athlete_dan_fouts	concept_sport_football
concept_athlete_dan_haren	concept_sport_baseball
concept_athlete_danilo_gallinari	concept_sport_basketball
concept_athlete_dany_heatley	concept_sport_hockey
concept_athlete_darcy_tucker	concept_sport_hockey
concept_athlete_darius_miles	concept_sport_basketball
concept_athlete_darius_songaila	concept_sport_basketball
concept_athlete_darrell_rasner	concept_sport_baseball
concept_athlete_darrelle_revis	concept_sport_football
concept_athlete_darren_collison	concept_sport_softball
concept_athlete_darren_mcfadden	concept_sport_football
concept_athlete_darren_sproles	concept_sport_football
concept_athlete_darrent_williams	concept_sport_football
concept_athlete_darrent_williams	concept_sport_hockey
concept_athlete_darrick_martin	concept_sport_football
concept_athlete_daryll_clark	concept_sport_football
concept_athlete_dave_bolland	concept_sport_hockey
concept_athlete_david_booth	concept_sport_football
concept_athlete_david_carr	concept_sport_hockey
concept_athlete_david_justice	concept_sport_baseball
concept_athlete_david_moss	concept_sport_hockey
concept_athlete_david_murphy	concept_sport_hockey
concept_athlete_david_ortiz	concept_sport_baseball
concept_athlete_david_wells	concept_sport_baseball
concept_athlete_daymond_langkow	concept_sport_hockey
concept_athlete_deion_branch	concept_sport_football
concept_athlete_delonte_west	concept_sport_basketball
concept_athlete_deltha_o_neal	concept_sport_basketball
concept_athlete_demarcus_ware	concept_sport_football
concept_athlete_derek_lowe	concept_sport_baseball
concept_athlete_deron_williams	concept_sport_basketball
concept_athlete_derosa	concept_sport_baseball
concept_athlete_derrick_turnbow	concept_sport_baseball
concept_athlete_desean_jackson	concept_sport_baseball
concept_athlete_desmond_mason	concept_sport_basketball
concept_athlete_deuce_mcallister	concept_sport_football
concept_athlete_devin_brown	concept_sport_basketball
concept_athlete_diaw	concept_sport_basketball
concept_athlete_dice_k	concept_sport_baseball
concept_athlete_dikembe_mutombo	concept_sport_basketball
concept_athlete_dimitar_berbatov	concept_sport_basketball
concept_athlete_dion_phaneuf	concept_sport_hockey
concept_athlete_dioner_navarro	concept_sport_hockey
concept_athlete_dirk_kuyt	concept_sport_football
concept_athlete_dirk_nowitzki	concept_sport_basketball
concept_athlete_dmitri_young	concept_sport_baseball
concept_athlete_dom_dimaggio	concept_sport_baseball
concept_athlete_dominic_moore	concept_sport_hockey
concept_athlete_dominik_hasek	concept_sport_hockey
concept_athlete_don_larsen	concept_sport_baseball
concept_athlete_donnie_avery	concept_sport_football
concept_athlete_donovan_mcnabb	concept_sport_football
concept_athlete_dontrelle_willis	concept_sport_baseball
concept_athlete_doug_williams	concept_sport_football
concept_athlete_drew_bledsoe	concept_sport_baseball
concept_athlete_drew_doughty	concept_sport_hockey
concept_athlete_duncan_keith	concept_sport_hockey
concept_athlete_dustin_byfuglien	concept_sport_hockey
concept_athlete_dustin_keller	concept_sport_football
concept_athlete_dustin_pedroia	concept_sport_baseball
concept_athlete_dustin_penner	concept_sport_hockey
concept_athlete_dwayne_roloson	concept_sport_hockey
concept_athlete_dwight_freeney	concept_sport_football
concept_athlete_dwight_howard	concept_sport_basketball
concept_athlete_dwight_lowery	concept_sport_football
concept_athlete_dwyane_wade	concept_sport_basketball
concept_athlete_dye	concept_sport_baseball
concept_athlete_ed_belfour	concept_sport_hockey
concept_athlete_eddy_curry	concept_sport_basketball
concept_athlete_eli_manning	concept_sport_football
concept_athlete_elton_brand	concept_sport_basketball
concept_athlete_elvin_ramirez	concept_sport_baseball
concept_athlete_emmitt_smith	concept_sport_football
concept_athlete_eric_byrnes	concept_sport_baseball
concept_athlete_eric_gordon	concept_sport_basketball
concept_athlete_eric_milton	concept_sport_baseball
concept_athlete_eric_staal	concept_sport_hockey
concept_athlete_erik_bedard	concept_sport_baseball
concept_athlete_erik_cole	concept_sport_hockey
concept_athlete_ernie_banks	concept_sport_baseball
concept_athlete_esteban_loaiza	concept_sport_baseball
concept_athlete_ethier	concept_sport_baseball
concept_athlete_evgeny_artyukhin	concept_sport_football
concept_athlete_farmar	concept_sport_basketball
concept_athlete_farve	concept_sport_football
concept_athlete_favre	concept_sport_football
concept_athlete_fedor_tyutin	concept_sport_hockey
concept_athlete_felix_hernandez	concept_sport_baseball
concept_athlete_felix_pie	concept_sport_baseball
concept_athlete_fernando_abad	concept_sport_baseball
concept_athlete_fernando_tatis	concept_sport_baseball
concept_athlete_francisco_garcia	concept_sport_baseball
concept_athlete_frank	concept_sport_basketball
concept_athlete_frank_walker	concept_sport_football
concept_athlete_franklin_guti_rrez	concept_sport_baseball
concept_athlete_freddy_garcia	concept_sport_baseball
concept_athlete_freddy_sanchez	concept_sport_baseball
concept_athlete_freddy_sanchez	concept_sport_hockey
concept_athlete_gabe_kapler	concept_sport_baseball
concept_athlete_gabe_kapler	concept_sport_hockey
concept_athlete_garret_anderson	concept_sport_basketball
concept_athlete_garrett_olson	concept_sport_baseball
concept_athlete_gary_carter	concept_sport_baseball
concept_athlete_gary_sheffield	concept_sport_baseball
concept_athlete_gasol	concept_sport_basketball
concept_athlete_gavin_floyd	concept_sport_baseball
concept_athlete_gehrig	concept_sport_baseball
concept_athlete_geoff_jenkins	concept_sport_baseball
concept_athlete_georges_laraque	concept_sport_hockey
concept_athlete_ginobili	concept_sport_basketball
concept_athlete_glavine	concept_sport_baseball
concept_athlete_glen_perkins	concept_sport_baseball
concept_athlete_grady_sizemore	concept_sport_baseball
concept_athlete_granger	concept_sport_basketball
concept_athlete_grant_hill	concept_sport_basketball
concept_athlete_greg_ellis	concept_sport_football
concept_athlete_greg_maddux	concept_sport_baseball
concept_athlete_hank_aaron	concept_sport_baseball
concept_athlete_hanley_ramirez	concept_sport_baseball
concept_athlete_harrison	concept_sport_football
concept_athlete_harry_kewell	concept_sport_football
concept_athlete_hassan_adams	concept_sport_basketball
concept_athlete_hasselbeck	concept_sport_football
concept_athlete_haynesworth	concept_sport_hockey
concept_athlete_heath_bell	concept_sport_basketball
concept_athlete_hedo_turkoglu	concept_sport_basketball
concept_athlete_henrik_lundqvist	concept_sport_hockey
concept_athlete_henrik_zetterberg	concept_sport_hockey
concept_athlete_hideki_okajima	concept_sport_baseball
concept_athlete_hideo_nomo	concept_sport_baseball
concept_athlete_hiroki_kuroda	concept_sport_baseball
concept_athlete_huet	concept_sport_hockey
concept_athlete_hunter_pence	concept_sport_baseball
concept_athlete_ian_johnson	concept_sport_basketball
concept_athlete_ichiro	concept_sport_baseball
concept_athlete_ichiro_suzuki	concept_sport_baseball
concept_athlete_ilya_bryzgalov	concept_sport_hockey
concept_athlete_isaac_bruce	concept_sport_football
concept_athlete_ivan_rodriguez	concept_sport_baseball
concept_athlete_iverson	concept_sport_basketball
concept_athlete_j_j__putz	concept_sport_baseball
concept_athlete_j_p__arencibia	concept_sport_football
concept_athlete_j_p__howell	concept_sport_football
concept_athlete_j_p__losman	concept_sport_football
concept_athlete_j_p__ricciardi	concept_sport_football
concept_athlete_j_r__smith	concept_sport_basketball
concept_athlete_jacoby_ellsbury	concept_sport_baseball
concept_athlete_jagr	concept_sport_hockey
concept_athlete_jair_jurrjens	concept_sport_baseball
concept_athlete_jake_delhomme	concept_sport_football
concept_athlete_jake_peavy	concept_sport_baseball
concept_athlete_jamaal_tinsley	concept_sport_basketball
concept_athlete_jamario_moon	concept_sport_basketball
concept_athlete_jameer_nelson	concept_sport_basketball
concept_athlete_james_farrior	concept_sport_football
concept_athlete_james_harrison	concept_sport_football
concept_athlete_james_loney	concept_sport_baseball
concept_athlete_james_posey	concept_sport_basketball
concept_athlete_james_shields	concept_sport_hockey
concept_athlete_jamie_moyer	concept_sport_baseball
concept_athlete_jared_allen	concept_sport_football
concept_athlete_jared_reiner	concept_sport_basketball
concept_athlete_jarome_iginla	concept_sport_hockey
concept_athlete_jaromir_jagr	concept_sport_hockey
concept_athlete_jaroslav_halak	concept_sport_hockey
concept_athlete_jarvis_hayes	concept_sport_basketball
concept_athlete_jason_blake	concept_sport_hockey
concept_athlete_jason_kapono	concept_sport_basketball
concept_athlete_jason_kendall	concept_sport_baseball
concept_athlete_jason_kidd	concept_sport_basketball
concept_athlete_jason_marquis	concept_sport_baseball
concept_athlete_jason_pominville	concept_sport_hockey
concept_athlete_jason_richardson	concept_sport_basketball
concept_athlete_jason_varitek	concept_sport_baseball
concept_athlete_javier_mascherano	concept_sport_football
concept_athlete_javier_vazquez	concept_sport_baseball
concept_athlete_javon_walker	concept_sport_football
concept_athlete_javon_walker	concept_sport_hockey
concept_athlete_jay_bouwmeester	concept_sport_football
concept_athlete_jay_cutler	concept_sport_football
concept_athlete_jay_cutler	concept_sport_hockey
concept_athlete_jay_pandolfo	concept_sport_hockey
concept_athlete_jay_payton	concept_sport_baseball
concept_athlete_jed_lowrie	concept_sport_baseball
concept_athlete_jeff_baker	concept_sport_baseball
concept_athlete_jeff_francoeur	concept_sport_baseball
concept_athlete_jeff_garcia	concept_sport_basketball
concept_athlete_jeff_garcia	concept_sport_football
concept_athlete_jeff_green	concept_sport_basketball
concept_athlete_jeff_kent	concept_sport_baseball
concept_athlete_jeff_samardzija	concept_sport_baseball
concept_athlete_jeff_suppan	concept_sport_baseball
concept_athlete_jeff_teague	concept_sport_basketball
concept_athlete_jeremy_bates	concept_sport_football
concept_athlete_jeremy_hermida	concept_sport_baseball
concept_athlete_jermaine_o_neal	concept_sport_basketball
concept_athlete_jerome_bettis	concept_sport_football
concept_athlete_jerome_james	concept_sport_basketball
concept_athlete_jerome_james	concept_sport_football
concept_athlete_jerry_rice	concept_sport_football
concept_athlete_jerry_stackhouse	concept_sport_basketball
concept_athlete_jerry_west	concept_sport_basketball
concept_athlete_jeter	concept_sport_baseball
concept_athlete_jhonny_peralta	concept_sport_baseball
concept_athlete_jim_edmonds	concept_sport_baseball
concept_athlete_jim_rice	concept_sport_baseball
concept_athlete_jimmy_howard	concept_sport_hockey
concept_athlete_jimmy_rollins	concept_sport_baseball
concept_athlete_jiri_hudler	concept_sport_hockey
concept_athlete_jj_redick	concept_sport_basketball
concept_athlete_joba_chamberlain	concept_sport_baseball
concept_athlete_joe_blanton	concept_sport_baseball
concept_athlete_joe_bradley	concept_sport_football
concept_athlete_joe_crede	concept_sport_baseball
concept_athlete_joe_dimaggio	concept_sport_baseball
concept_athlete_joe_flacco	concept_sport_football
concept_athlete_joe_girardi	concept_sport_baseball
concept_athlete_joe_gordon	concept_sport_baseball
concept_athlete_joe_namath	concept_sport_football
concept_athlete_joe_pepitone	concept_sport_baseball
concept_athlete_joe_sakic	concept_sport_hockey
concept_athlete_joe_thornton	concept_sport_hockey
concept_athlete_joey_harrington	concept_sport_football
concept_athlete_joey_macdonald	concept_sport_hockey
concept_athlete_joey_porter	concept_sport_football
concept_athlete_johan_franzen	concept_sport_hockey
concept_athlete_johan_santana	concept_sport_baseball
concept_athlete_john_barnes	concept_sport_football
concept_athlete_john_cassell	concept_sport_football
concept_athlete_john_david_booty	concept_sport_basketball
concept_athlete_john_madden	concept_sport_hockey
concept_athlete_john_smoltz	concept_sport_baseball
concept_athlete_john_ward	concept_sport_football
concept_athlete_johnny_estrada	concept_sport_baseball
concept_athlete_jon_lester	concept_sport_baseball
concept_athlete_jonathan_sanchez	concept_sport_football
concept_athlete_jonathan_stewart	concept_sport_football
concept_athlete_jonathan_toews	concept_sport_hockey
concept_athlete_jones	concept_sport_football
concept_athlete_jordan_staal	concept_sport_hockey
concept_athlete_jordin_tootoo	concept_sport_hockey
concept_athlete_jorge_garbajosa	concept_sport_basketball
concept_athlete_jorvorskie_lane	concept_sport_football
concept_athlete_jose_calderon	concept_sport_basketball
concept_athlete_jose_reyes	concept_sport_baseball
concept_athlete_joseph_addai	concept_sport_football
concept_athlete_josh_fogg	concept_sport_baseball
concept_athlete_josh_howard	concept_sport_basketball
concept_athlete_josh_smith	concept_sport_basketball
concept_athlete_julius_erving	concept_sport_basketball
concept_athlete_junichi_tazawa	concept_sport_baseball
concept_athlete_junior_seau	concept_sport_football
concept_athlete_justin_fargas	concept_sport_football
concept_athlete_justin_morneau	concept_sport_baseball
concept_athlete_justin_tuck	concept_sport_football
concept_athlete_justin_upton	concept_sport_baseball
concept_athlete_kei_igawa	concept_sport_baseball
concept_athlete_keith_hernandez	concept_sport_baseball
concept_athlete_kelly_johnson	concept_sport_baseball
concept_athlete_kelly_shoppach	concept_sport_baseball
concept_athlete_ken_dorsey	concept_sport_football
concept_athlete_kendrick_perkins	concept_sport_basketball
concept_athlete_kenji_johjima	concept_sport_baseball
concept_athlete_kenny_lofton	concept_sport_baseball
concept_athlete_kerry_wood	concept_sport_baseball
concept_athlete_kevin_bieksa	concept_sport_hockey
concept_athlete_kevin_durant	concept_sport_basketball
concept_athlete_kevin_kolb	concept_sport_baseball
concept_athlete_kevin_kouzmanoff	concept_sport_baseball
concept_athlete_kevin_mchale	concept_sport_basketball
concept_athlete_kirilenko	concept_sport_basketball
concept_athlete_kirk_gibson	concept_sport_baseball
concept_athlete_kirk_hinrich	concept_sport_basketball
concept_athlete_kirk_maltby	concept_sport_hockey
concept_athlete_kris_benson	concept_sport_baseball
concept_athlete_kris_draper	concept_sport_hockey
concept_athlete_kurt_warner	concept_sport_football
concept_athlete_kwame_brown	concept_sport_basketball
concept_athlete_kyle_orton	concept_sport_football
concept_athlete_ladell_betts	concept_sport_football
concept_athlete_lamar_odom	concept_sport_basketball
concept_athlete_lamarcus_aldridge	concept_sport_basketball
concept_athlete_larry_foote	concept_sport_football
concept_athlete_larry_johnson	concept_sport_football
concept_athlete_larry_robinson	concept_sport_hockey
concept_athlete_lawrence_taylor	concept_sport_football
concept_athlete_lebron	concept_sport_basketball
concept_athlete_leon_powe	concept_sport_basketball
concept_athlete_liam_reddox	concept_sport_hockey
concept_athlete_lidge	concept_sport_baseball
concept_athlete_lidstrom	concept_sport_hockey
concept_athlete_limas_sweed	concept_sport_football
concept_athlete_linas_kleiza	concept_sport_basketball
concept_athlete_lindsey_hunter	concept_sport_basketball
concept_athlete_livan_hernandez	concept_sport_baseball
concept_athlete_logan_kensing	concept_sport_baseball
concept_athlete_longoria	concept_sport_hockey
concept_athlete_lou_gehrig	concept_sport_baseball
concept_athlete_lou_piniella	concept_sport_baseball
concept_athlete_lt__joseph_r__hunt	concept_sport_hockey
concept_athlete_luis_castillo	concept_sport_baseball
concept_athlete_luis_garcia	concept_sport_football
concept_athlete_luis_scola	concept_sport_basketball
concept_athlete_luis_vizcaino	concept_sport_baseball
concept_athlete_luka_modric	concept_sport_basketball
concept_athlete_luke_harangody	concept_sport_football
concept_athlete_luke_ridnour	concept_sport_basketball
concept_athlete_luke_scott	concept_sport_baseball
concept_athlete_lundqvist	concept_sport_hockey
concept_athlete_luol_deng	concept_sport_basketball
concept_athlete_luther_head	concept_sport_basketball
concept_athlete_magic_johnson	concept_sport_basketball
concept_athlete_manu_ginobili	concept_sport_basketball
concept_athlete_marc_bulger	concept_sport_football
concept_athlete_marc_gasol	concept_sport_basketball
concept_athlete_marc_staal	concept_sport_hockey
concept_athlete_marcus_banks	concept_sport_baseball
concept_athlete_marcus_camby	concept_sport_basketball
concept_athlete_marcus_spears	concept_sport_football
concept_athlete_marcus_williams	concept_sport_basketball
concept_athlete_mario_chalmers	concept_sport_basketball
concept_athlete_mark_derosa	concept_sport_baseball
concept_athlete_mark_grace	concept_sport_baseball
concept_athlete_mark_hendrickson	concept_sport_baseball
concept_athlete_mark_kotsay	concept_sport_baseball
concept_athlete_mark_reynolds	concept_sport_baseball
concept_athlete_mark_rogers	concept_sport_basketball
concept_athlete_mark_sanchez	concept_sport_basketball
concept_athlete_mark_teixeira	concept_sport_baseball
concept_athlete_markus_naslund	concept_sport_hockey
concept_athlete_marlon_byrd	concept_sport_hockey
concept_athlete_marques_colston	concept_sport_football
concept_athlete_marquis_daniels	concept_sport_basketball
concept_athlete_marshawn_lynch	concept_sport_football
concept_athlete_marshawn_lynch	concept_sport_hockey
concept_athlete_martell_webster	concept_sport_basketball
concept_athlete_martin_brodeur	concept_sport_hockey
concept_athlete_martin_havlat	concept_sport_hockey
concept_athlete_marty_turco	concept_sport_hockey
concept_athlete_marvin_harrison	concept_sport_football
concept_athlete_marvin_williams	concept_sport_basketball
concept_athlete_mathieu_garon	concept_sport_hockey
concept_athlete_mathieu_schneider	concept_sport_hockey
concept_athlete_mats_sundin	concept_sport_hockey
concept_athlete_matt_cain	concept_sport_football
concept_athlete_matt_garza	concept_sport_hockey
concept_athlete_matt_harpring	concept_sport_basketball
concept_athlete_matt_hasselbeck	concept_sport_football
concept_athlete_matt_jones	concept_sport_football
concept_athlete_matt_morris	concept_sport_hockey
concept_athlete_matt_murton	concept_sport_baseball
concept_athlete_matt_ryan	concept_sport_football
concept_athlete_matt_schaub	concept_sport_hockey
concept_athlete_mattias_ohlund	concept_sport_hockey
concept_athlete_mattias_weinhandl	concept_sport_hockey
concept_athlete_maury_wills	concept_sport_baseball
concept_athlete_max_ramirez	concept_sport_hockey
concept_athlete_mcgrady	concept_sport_basketball
concept_athlete_mcnabb	concept_sport_baseball
concept_athlete_mcnair	concept_sport_football
concept_athlete_mehmet_okur	concept_sport_basketball
concept_athlete_mewelde_moore	concept_sport_football
concept_athlete_micah_richards	concept_sport_basketball
concept_athlete_michael_ballack	concept_sport_golf
concept_athlete_michael_beasley	concept_sport_basketball
concept_athlete_michael_doleac	concept_sport_basketball
concept_athlete_michael_finley	concept_sport_basketball
concept_athlete_michael_redd	concept_sport_basketball
concept_athlete_michael_ryder	concept_sport_hockey
concept_athlete_michael_strahan	concept_sport_football
concept_athlete_michael_vick	concept_sport_football
concept_athlete_michael_young	concept_sport_hockey
concept_athlete_michal_rozsival	concept_sport_hockey
concept_athlete_michel_goulet	concept_sport_hockey
concept_athlete_mickey_cochrane	concept_sport_baseball
concept_athlete_miikka_kiprusoff	concept_sport_hockey
concept_athlete_mike_aviles	concept_sport_hockey
concept_athlete_mike_bibby	concept_sport_basketball
concept_athlete_mike_cameron	concept_sport_baseball
concept_athlete_mike_dunleavy	concept_sport_basketball
concept_athlete_mike_fisher	concept_sport_hockey
concept_athlete_mike_green	concept_sport_hockey
concept_athlete_mike_jacobs	concept_sport_baseball
concept_athlete_mike_komisarek	concept_sport_hockey
concept_athlete_mike_lowell	concept_sport_baseball
concept_athlete_mike_miller	concept_sport_basketball
concept_athlete_mike_modano	concept_sport_hockey
concept_athlete_mike_mussina	concept_sport_baseball
concept_athlete_mike_piazza	concept_sport_baseball
concept_athlete_mike_richter	concept_sport_hockey
concept_athlete_mike_singletary	concept_sport_football
concept_athlete_mike_smith	concept_sport_football
concept_athlete_milton_bradley	concept_sport_baseball
concept_athlete_miroslav_klose	concept_sport_golf
concept_athlete_mo_williams	concept_sport_basketball
concept_athlete_moises_alou	concept_sport_baseball
concept_athlete_monta_ellis	concept_sport_basketball
concept_athlete_morris_peterson	concept_sport_basketball
concept_athlete_mussina	concept_sport_baseball
concept_athlete_nacho_novo	concept_sport_hockey
concept_athlete_nady	concept_sport_baseball
concept_athlete_najeh_davenport	concept_sport_football
concept_athlete_nani	concept_sport_basketball
concept_athlete_nate_burleson	concept_sport_football
concept_athlete_nenad_krstic	concept_sport_basketball
concept_athlete_nene	concept_sport_basketball
concept_athlete_nick_blackburn	concept_sport_baseball
concept_athlete_nick_markakis	concept_sport_baseball
concept_athlete_nick_punto	concept_sport_baseball
concept_athlete_nick_swisher	concept_sport_baseball
concept_athlete_nick_young	concept_sport_basketball
concept_athlete_nicklas_backstrom	concept_sport_hockey
concept_athlete_nicklas_lidstrom	concept_sport_hockey
concept_athlete_nigel_dawes	concept_sport_hockey
concept_athlete_niklas_backstrom	concept_sport_hockey
concept_athlete_niklas_kronwall	concept_sport_hockey
concept_athlete_nikolai_khabibulin	concept_sport_hockey
concept_athlete_nikolai_kulemin	concept_sport_hockey
concept_athlete_noah_lowry	concept_sport_football
concept_athlete_nolan_ryan	concept_sport_baseball
concept_athlete_nomar_garciaparra	concept_sport_baseball
concept_athlete_o__j__simpson	concept_sport_basketball
concept_athlete_oliver_perez	concept_sport_baseball
concept_athlete_olmedo_saenz	concept_sport_baseball
concept_athlete_orel_hershiser	concept_sport_baseball
concept_athlete_orlando_cabrera	concept_sport_baseball
concept_athlete_oscar_villarreal	concept_sport_baseball
concept_athlete_osi_umenyiora	concept_sport_football
concept_athlete_ovechkin	concept_sport_hockey
concept_athlete_p_j__axelsson	concept_sport_hockey
concept_athlete_p_j__walters	concept_sport_football
concept_athlete_pacman_jones	concept_sport_football
concept_athlete_pat_burrell	concept_sport_hockey
concept_athlete_patrick_marleau	concept_sport_hockey
concept_athlete_patrick_sharp	concept_sport_hockey
concept_athlete_patrick_vieira	concept_sport_golf
concept_athlete_pau_gasol	concept_sport_basketball
concept_athlete_paul_konerko	concept_sport_baseball
concept_athlete_paul_lo_duca	concept_sport_baseball
concept_athlete_paul_mara	concept_sport_hockey
concept_athlete_paul_millsap	concept_sport_basketball
concept_athlete_paul_pierce	concept_sport_basketball
concept_athlete_paul_scholes	concept_sport_basketball
concept_athlete_pavel_datsyuk	concept_sport_hockey
concept_athlete_pavel_kubina	concept_sport_hockey
concept_athlete_peavy	concept_sport_baseball
concept_athlete_pedroia	concept_sport_baseball
concept_athlete_peja_stojakovic	concept_sport_basketball
concept_athlete_pele	concept_sport_golf
concept_athlete_pelfrey	concept_sport_baseball
concept_athlete_percy_harvin	concept_sport_basketball
concept_athlete_peter_crouch	concept_sport_football
concept_athlete_petr_prucha	concept_sport_hockey
concept_athlete_petr_sykora	concept_sport_hockey
concept_athlete_pettitte	concept_sport_baseball
concept_athlete_peyton_hillis	concept_sport_hockey
concept_athlete_peyton_manning	concept_sport_football
concept_athlete_phil_coke	concept_sport_football
concept_athlete_phil_hughes_and_ian_kennedy	concept_sport_baseball
concept_athlete_phil_rizzuto	concept_sport_baseball
concept_athlete_phil_simms	concept_sport_football
concept_athlete_pierre_pilote	concept_sport_hockey
concept_athlete_plaxico	concept_sport_football
concept_athlete_plaxico_burress	concept_sport_football
concept_athlete_portis	concept_sport_football
concept_athlete_priest_holmes	concept_sport_football
concept_athlete_prince_fielder	concept_sport_baseball
concept_athlete_pujols	concept_sport_baseball
concept_athlete_putz	concept_sport_baseball
concept_athlete_quarterback_ben_roethlisberger	concept_sport_football
concept_athlete_quarterback_matt_ryan	concept_sport_football
concept_athlete_rafael_furcal	concept_sport_baseball
concept_athlete_rafael_soriano	concept_sport_baseball
concept_athlete_rafer_alston	concept_sport_basketball
concept_athlete_raja_bell	concept_sport_basketball
concept_athlete_rajai_davis	concept_sport_baseball
concept_athlete_rajon_rondo	concept_sport_basketball
concept_athlete_ramirez	concept_sport_baseball
concept_athlete_ramon_castro	concept_sport_baseball
concept_athlete_ramon_ramirez	concept_sport_baseball
concept_athlete_ramon_sessions	concept_sport_basketball
concept_athlete_randall_simon	concept_sport_baseball
concept_athlete_randall_simon	concept_sport_hockey
concept_athlete_randy	concept_sport_football
concept_athlete_randy_foye	concept_sport_basketball
concept_athlete_randy_johnson	concept_sport_baseball
concept_athlete_randy_wolf	concept_sport_baseball
concept_athlete_rashard_lewis	concept_sport_basketball
concept_athlete_rashard_mendenhall	concept_sport_football
concept_athlete_raul_ibanez	concept_sport_baseball
concept_athlete_ray_allen	concept_sport_basketball
concept_athlete_ray_lewis	concept_sport_football
concept_athlete_raymar_morgan	concept_sport_basketball
concept_athlete_reggie_bush	concept_sport_football
concept_athlete_reggie_wayne	concept_sport_football
concept_athlete_reggie_white	concept_sport_football
concept_athlete_renaldo_balkman	concept_sport_basketball
concept_athlete_rene_bourque	concept_sport_hockey
concept_athlete_renteria	concept_sport_baseball
concept_athlete_rich_aurilia	concept_sport_football
concept_athlete_rich_gannon	concept_sport_football
concept_athlete_rich_harden	concept_sport_baseball
concept_athlete_rich_hill	concept_sport_hockey
concept_athlete_rick_dipietro	concept_sport_hockey
concept_athlete_rick_nash	concept_sport_hockey
concept_athlete_rick_pitino	concept_sport_basketball
concept_athlete_rickey_henderson	concept_sport_baseball
concept_athlete_ricky_williams	concept_sport_football
concept_athlete_rio_ferdinand	concept_sport_basketball
concept_athlete_rob_niedermayer	concept_sport_hockey
concept_athlete_robert_horry	concept_sport_basketball
concept_athlete_robert_meachem	concept_sport_football
concept_athlete_robert_nilsson	concept_sport_hockey
concept_athlete_roberto_alomar	concept_sport_baseball
concept_athlete_roberto_luongo	concept_sport_hockey
concept_athlete_robinho	concept_sport_basketball
concept_athlete_robinson_cano	concept_sport_baseball
concept_athlete_rocco_baldelli	concept_sport_baseball
concept_athlete_rocco_baldelli	concept_sport_hockey
concept_athlete_rod_smith	concept_sport_football
concept_athlete_roddy_white	concept_sport_football
concept_athlete_rodney_stuckey	concept_sport_basketball
concept_athlete_roethlisberger	concept_sport_football
concept_athlete_romo	concept_sport_football
concept_athlete_ron_artest	concept_sport_basketball
concept_athlete_ron_villone	concept_sport_baseball
concept_athlete_ronaldo	concept_sport_basketball
concept_athlete_ronnie_brewer	concept_sport_basketball
concept_athlete_ronny_cedeno	concept_sport_baseball
concept_athlete_ronny_turiaf	concept_sport_basketball
concept_athlete_rosenfels	concept_sport_hockey
concept_athlete_roy_halladay	concept_sport_baseball
concept_athlete_roy_williams	concept_sport_football
concept_athlete_rudi_johnson	concept_sport_baseball
concept_athlete_rudi_johnson	concept_sport_football
concept_athlete_rudy_gay	concept_sport_basketball
concept_athlete_ruslan_fedotenko	concept_sport_hockey
concept_athlete_russell_branyan	concept_sport_baseball
concept_athlete_russell_wilson	concept_sport_football
concept_athlete_ryan	concept_sport_football
concept_athlete_ryan_babel	concept_sport_football
concept_athlete_ryan_braun	concept_sport_baseball
concept_athlete_ryan_callahan	concept_sport_hockey
concept_athlete_ryan_carter	concept_sport_hockey
concept_athlete_ryan_dempster	concept_sport_baseball
concept_athlete_ryan_getzlaf	concept_sport_hockey
concept_athlete_ryan_giggs	concept_sport_basketball
concept_athlete_ryan_gomes	concept_sport_basketball
concept_athlete_ryan_hall	concept_sport_hockey
concept_athlete_ryan_kesler	concept_sport_hockey
concept_athlete_ryan_klesko	concept_sport_baseball
concept_athlete_ryan_malone	concept_sport_hockey
concept_athlete_ryan_theriot	concept_sport_baseball
concept_athlete_sabathia	concept_sport_baseball
concept_athlete_sage_rosenfels	concept_sport_hockey
concept_athlete_sam_bradford	concept_sport_basketball
concept_athlete_sam_gagner	concept_sport_hockey
concept_athlete_sandy_koufax	concept_sport_baseball
concept_athlete_santana_moss	concept_sport_football
concept_athlete_santonio_holmes	concept_sport_football
concept_athlete_savard	concept_sport_hockey
concept_athlete_schaub	concept_sport_hockey
concept_athlete_scott_baker	concept_sport_baseball
concept_athlete_scott_clemmensen	concept_sport_hockey
concept_athlete_scott_gomez_and_chris_drury	concept_sport_hockey
concept_athlete_scott_kazmir	concept_sport_football
concept_athlete_scott_niedermayer	concept_sport_hockey
concept_athlete_scott_olsen	concept_sport_baseball
concept_athlete_sean_avery	concept_sport_hockey
concept_athlete_sean_taylor	concept_sport_football
concept_athlete_sean_williams	concept_sport_basketball
concept_athlete_semin	concept_sport_hockey
concept_athlete_shane_battier	concept_sport_basketball
concept_athlete_shane_doan	concept_sport_hockey
concept_athlete_shane_victorino	concept_sport_baseball
concept_athlete_shaq	concept_sport_basketball
concept_athlete_shaun_livingston	concept_sport_basketball
concept_athlete_shaun_wright_phillips	concept_sport_basketball
concept_athlete_shawn_green	concept_sport_baseball
concept_athlete_shawne_merriman	concept_sport_football
concept_athlete_shortstops_juan_uribe	concept_sport_baseball
concept_athlete_sidney_crosby	concept_sport_hockey
concept_athlete_sidney_ponson	concept_sport_baseball
concept_athlete_smoltz	concept_sport_baseball
concept_athlete_stan_mikita	concept_sport_hockey
concept_athlete_stephon_marbury	concept_sport_basketball
concept_athlete_steve_bernier	concept_sport_hockey
concept_athlete_steve_blake	concept_sport_basketball
concept_athlete_steve_francis	concept_sport_basketball
concept_athlete_steve_mason	concept_sport_hockey
concept_athlete_steve_nash	concept_sport_basketball
concept_athlete_steve_slaton	concept_sport_hockey
concept_athlete_steve_smith	concept_sport_football
concept_athlete_steve_trachsel	concept_sport_baseball
concept_athlete_steve_valiquette	concept_sport_hockey
concept_athlete_steve_yzerman	concept_sport_hockey
concept_athlete_t__j__ford	concept_sport_basketball
concept_athlete_tatum_bell	concept_sport_hockey
concept_athlete_tayshaun_prince	concept_sport_basketball
concept_athlete_ted_thompson	concept_sport_football
concept_athlete_ted_williams	concept_sport_baseball
concept_athlete_teemu_selanne	concept_sport_hockey
concept_athlete_teixeira	concept_sport_baseball
concept_athlete_tejada	concept_sport_baseball
concept_athlete_terrell_owens	concept_sport_football
concept_athlete_terrelle_pryor	concept_sport_basketball
concept_athlete_terry_glenn	concept_sport_football
concept_athlete_thabo_sefolosha	concept_sport_basketball
concept_athlete_thaddeus_young	concept_sport_basketball
concept_athlete_thierry_henry	concept_sport_golf
concept_athlete_thome	concept_sport_baseball
concept_athlete_tiki_barber	concept_sport_football
concept_athlete_tim_dillard	concept_sport_baseball
concept_athlete_tim_duncan	concept_sport_basketball
concept_athlete_tim_hudson	concept_sport_baseball
concept_athlete_tim_lincecum	concept_sport_football
concept_athlete_tim_redding	concept_sport_baseball
concept_athlete_tim_tebow	concept_sport_basketball
concept_athlete_tim_thomas	concept_sport_basketball
concept_athlete_tim_thomas	concept_sport_hockey
concept_athlete_tim_wakefield	concept_sport_baseball
concept_athlete_tom_glavine	concept_sport_baseball
concept_athlete_tom_gorzelanny	concept_sport_baseball
concept_athlete_tom_gorzelanny	concept_sport_hockey
concept_athlete_tom_seaver	concept_sport_baseball
concept_athlete_tomas_holmstrom	concept_sport_hockey
concept_athlete_tomas_kopecky	concept_sport_hockey
concept_athlete_tomas_vokoun	concept_sport_football
concept_athlete_tomlinson	concept_sport_football
concept_athlete_tommy_maddox	concept_sport_football
concept_athlete_tony_battie	concept_sport_basketball
concept_athlete_tony_clark	concept_sport_baseball
concept_athlete_tony_dorsett	concept_sport_football
concept_athlete_tony_esposito	concept_sport_hockey
concept_athlete_tony_gonzalez	concept_sport_football
concept_athlete_tony_romo	concept_sport_football
concept_athlete_torii_hunter	concept_sport_baseball
concept_athlete_tracy_mcgrady	concept_sport_basketball
concept_athlete_travis_hafner	concept_sport_baseball
concept_athlete_travis_moen	concept_sport_hockey
concept_athlete_travis_snider	concept_sport_baseball
concept_athlete_travis_zajac	concept_sport_hockey
concept_athlete_trent_hunter	concept_sport_hockey
concept_athlete_trevor_hoffman	concept_sport_baseball
concept_athlete_trot_nixon	concept_sport_baseball
concept_athlete_troy_brouwer	concept_sport_hockey
concept_athlete_troy_polamalu	concept_sport_football
concept_athlete_troy_smith	concept_sport_football
concept_athlete_troy_tulowitzki	concept_sport_baseball
concept_athlete_turkoglu	concept_sport_basketball
concept_athlete_tuukka_rask	concept_sport_hockey
concept_athlete_ty_conklin	concept_sport_hockey
concept_athlete_ty_wigginton	concept_sport_baseball
concept_athlete_tyler_hansbrough	concept_sport_basketball
concept_athlete_tyler_smith	concept_sport_golf
concept_athlete_tyler_thigpen	concept_sport_football
concept_athlete_tyrus_thomas	concept_sport_basketball
concept_athlete_tyson_chandler	concept_sport_basketball
concept_athlete_udonis_haslem	concept_sport_basketball
concept_athlete_urlacher	concept_sport_football
concept_athlete_valtteri_filppula	concept_sport_hockey
concept_athlete_varitek	concept_sport_baseball
concept_athlete_vernon_gholston	concept_sport_basketball
concept_athlete_vernon_wells	concept_sport_baseball
concept_athlete_ville_peltonen	concept_sport_football
concept_athlete_vinny_lecavalier	concept_sport_football
concept_athlete_vladimir_radmanovic	concept_sport_basketball
concept_athlete_wade_boggs	concept_sport_baseball
concept_athlete_wallace	concept_sport_football
concept_athlete_wally_szczerbiak	concept_sport_basketball
concept_athlete_wandy_rodriguez	concept_sport_baseball
concept_athlete_wayne_ellington	concept_sport_basketball
concept_athlete_wayne_rooney	concept_sport_basketball
concept_athlete_williams	concept_sport_basketball
concept_athlete_willie_randolph	concept_sport_baseball
concept_athlete_willis	concept_sport_baseball
concept_athlete_willis_mcgahee	concept_sport_football
concept_athlete_xabi	concept_sport_football
concept_athlete_xavier_nady	concept_sport_baseball
concept_athlete_yi_jianlian	concept_sport_basketball
concept_athlete_yunel_escobar	concept_sport_baseball
concept_athlete_zach_parise	concept_sport_hockey
concept_athlete_zach_randolph	concept_sport_basketball
concept_athlete_zach_thomas	concept_sport_football
concept_athlete_zack_greinke	concept_sport_hockey
concept_athlete_zaun	concept_sport_baseball
concept_athlete_zaza_pachulia	concept_sport_basketball
concept_athlete_zinedine_zidane	concept_sport_golf
concept_athlete_zydrunas_ilgauskas	concept_sport_basketball
concept_celebrity_quentin_richardson	concept_sport_basketball
concept_coach_a_j__burnett	concept_sport_baseball
concept_coach_a_j__hawk	concept_sport_baseball
concept_coach_aaron_boone	concept_sport_baseball
concept_coach_aaron_harang	concept_sport_baseball
concept_coach_aaron_harang	concept_sport_hockey
concept_coach_adam_laroche	concept_sport_baseball
concept_coach_adrian_peterson	concept_sport_football
concept_coach_al_harrington	concept_sport_basketball
concept_coach_al_jefferson	concept_sport_basketball
concept_coach_al_wilson	concept_sport_football
concept_coach_al_wilson	concept_sport_hockey
concept_coach_albert_belle	concept_sport_baseball
concept_coach_alex_gordon	concept_sport_baseball
concept_coach_alex_gordon	concept_sport_hockey
concept_coach_alexei_yashin	concept_sport_hockey
concept_coach_andre_ethier	concept_sport_baseball
concept_coach_andrei_kostitsyn	concept_sport_hockey
concept_coach_andrew_brunette	concept_sport_hockey
concept_coach_andrew_ladd	concept_sport_hockey
concept_coach_andrew_raycroft	concept_sport_hockey
concept_coach_andy_mcdonald	concept_sport_hockey
concept_coach_andy_pettite	concept_sport_baseball
concept_coach_andy_reid	concept_sport_football
concept_coach_bill_belichick	concept_sport_football
concept_coach_bill_parcells	concept_sport_football
concept_coach_bill_romanowski	concept_sport_football
concept_coach_bill_romanowski	concept_sport_hockey
concept_coach_bill_walsh	concept_sport_football
concept_coach_billy_butler	concept_sport_baseball
concept_coach_billy_butler	concept_sport_hockey
concept_coach_blake_comeau	concept_sport_hockey
concept_coach_bob_pettit	concept_sport_basketball
concept_coach_bob_sanders	concept_sport_football
concept_coach_bobby_jackson	concept_sport_basketball
concept_coach_bobby_ryan	concept_sport_hockey
concept_coach_brad_childress	concept_sport_football
concept_coach_brad_hawpe	concept_sport_baseball
concept_coach_brad_thompson	concept_sport_football
concept_coach_brady_quinn	concept_sport_football
concept_coach_brandon_braboy	concept_sport_basketball
concept_coach_brandon_braboy	concept_sport_football
concept_coach_brandon_dubinsky	concept_sport_hockey
concept_coach_brendan_shanahan	concept_sport_hockey
concept_coach_brett_carroll	concept_sport_basketball
concept_coach_brett_hull	concept_sport_hockey
concept_coach_brett_myers	concept_sport_baseball
concept_coach_brian_rolston	concept_sport_hockey
concept_coach_brooks_orpik	concept_sport_hockey
concept_coach_byron_scott	concept_sport_football
concept_coach_cal_ripken	concept_sport_baseball
concept_coach_carlos_marmol	concept_sport_baseball
concept_coach_chad_larose	concept_sport_hockey
concept_coach_chad_pennington	concept_sport_football
concept_coach_chris_johnson	concept_sport_football
concept_coach_chris_johnson	concept_sport_hockey
concept_coach_chris_paul	concept_sport_basketball
concept_coach_chris_paul	concept_sport_football
concept_coach_chris_quinn	concept_sport_basketball
concept_coach_chris_simon	concept_sport_hockey
concept_coach_chris_volstad	concept_sport_baseball
concept_coach_chuck_kobasew	concept_sport_hockey
concept_coach_chuck_noll	concept_sport_football
concept_coach_clarke_macarthur	concept_sport_hockey
concept_coach_clint_barmes	concept_sport_baseball
concept_coach_clinton_portis	concept_sport_football
concept_coach_colt_brennan	concept_sport_football
concept_coach_cory_sullivan	concept_sport_baseball
concept_coach_cowher	concept_sport_football
concept_coach_crennel	concept_sport_football
concept_coach_curtis_joseph	concept_sport_hockey
concept_coach_daniel_sedin	concept_sport_hockey
concept_coach_dany_sabourin	concept_sport_hockey
concept_coach_daunte_culpepper	concept_sport_football
concept_coach_dave_winfield	concept_sport_baseball
concept_coach_david_clarkson	concept_sport_hockey
concept_coach_david_garrard	concept_sport_football
concept_coach_david_garrard	concept_sport_hockey
concept_coach_david_krejci	concept_sport_hockey
concept_coach_deangelo_hall	concept_sport_football
concept_coach_denard_span	concept_sport_baseball
concept_coach_denis_grebeshkov	concept_sport_hockey
concept_coach_dennis_green	concept_sport_football
concept_coach_derek_roy	concept_sport_hockey
concept_coach_derrek_lee	concept_sport_baseball
concept_coach_derrek_lee	concept_sport_hockey
concept_coach_derrick_rose	concept_sport_basketball
concept_coach_derrick_ward	concept_sport_football
concept_coach_devin_thomas	concept_sport_football
concept_coach_dom_capers	concept_sport_football
concept_coach_doug_weight	concept_sport_hockey
concept_coach_drew_stafford	concept_sport_hockey
concept_coach_dungy	concept_sport_football
concept_coach_dustin_mcgowan	concept_sport_baseball
concept_coach_dwayne_wade	concept_sport_basketball
concept_coach_earnest_graham	concept_sport_football
concept_coach_eddie_royal	concept_sport_football
concept_coach_eddie_royal	concept_sport_hockey
concept_coach_eric_wedge	concept_sport_baseball
concept_coach_ervin_santana	concept_sport_baseball
concept_coach_evgeni_malkin	concept_sport_hockey
concept_coach_evgeni_nabokov	concept_sport_hockey
concept_coach_fernando_pisani	concept_sport_hockey
concept_coach_frank_robinson	concept_sport_baseball
concept_coach_frank_robinson	concept_sport_basketball
concept_coach_frans_nielsen	concept_sport_hockey
concept_coach_fred_lynn	concept_sport_baseball
concept_coach_freddy_meyer	concept_sport_hockey
concept_coach_fredrik_sjostrom	concept_sport_hockey
concept_coach_gale_sayers	concept_sport_football
concept_coach_garrett_atkins	concept_sport_baseball
concept_coach_garrett_wilson	concept_sport_basketball
concept_coach_gary_matthews_jr_	concept_sport_baseball
concept_coach_george_parros	concept_sport_hockey
concept_coach_gio_gonzalez	concept_sport_hockey
concept_coach_greg_oden	concept_sport_basketball
concept_coach_gruden	concept_sport_football
concept_coach_guillaume_latendresse	concept_sport_hockey
concept_coach_guillermo_diaz001	concept_sport_basketball
concept_coach_hank_stram	concept_sport_football
concept_coach_hannu_toivonen	concept_sport_hockey
concept_coach_hassan_adams	concept_sport_basketball
concept_coach_henrik_sedin	concept_sport_hockey
concept_coach_holliday	concept_sport_baseball
concept_coach_ian_snell	concept_sport_hockey
concept_coach_ilya_kovalchuk	concept_sport_hockey
concept_coach_j_a_happ	concept_sport_baseball
concept_coach_j_j__hardy	concept_sport_baseball
concept_coach_jack_del_rio	concept_sport_football
concept_coach_jake_plummer	concept_sport_football
concept_coach_jake_plummer	concept_sport_hockey
concept_coach_jakub_voracek	concept_sport_hockey
concept_coach_jamal_mayers	concept_sport_hockey
concept_coach_jamarcus_russell	concept_sport_football
concept_coach_james_hardy	concept_sport_football
concept_coach_james_hardy	concept_sport_hockey
concept_coach_jarkko_ruutu	concept_sport_hockey
concept_coach_jason_bay	concept_sport_baseball
concept_coach_jason_bay	concept_sport_hockey
concept_coach_jason_campbell	concept_sport_football
concept_coach_jason_labarbera	concept_sport_hockey
concept_coach_jason_williams	concept_sport_basketball
concept_coach_jauron	concept_sport_football
concept_coach_jay_bruce	concept_sport_baseball
concept_coach_jay_feely	concept_sport_football
concept_coach_jean_sebastien_giguere	concept_sport_hockey
concept_coach_jeff_bennett	concept_sport_hockey
concept_coach_jeff_fisher	concept_sport_football
concept_coach_jeremiah_trotter	concept_sport_baseball
concept_coach_jeremy_sowers	concept_sport_baseball
concept_coach_jerious_norwood	concept_sport_football
concept_coach_jim_haslett	concept_sport_football
concept_coach_jim_lonborg	concept_sport_baseball
concept_coach_jim_zorn	concept_sport_football
concept_coach_jocelyn_thibault	concept_sport_hockey
concept_coach_jochen_hecht	concept_sport_hockey
concept_coach_joe_gibbs	concept_sport_football
concept_coach_joe_mauer	concept_sport_baseball
concept_coach_joe_tinker	concept_sport_baseball
concept_coach_joe_torre	concept_sport_baseball
concept_coach_joey_galloway	concept_sport_football
concept_coach_joey_gathright	concept_sport_baseball
concept_coach_john_curry	concept_sport_hockey
concept_coach_john_fox	concept_sport_football
concept_coach_john_maine	concept_sport_baseball
concept_coach_john_mcgraw	concept_sport_football
concept_coach_johnny_damon	concept_sport_baseball
concept_coach_jose_guillen	concept_sport_baseball
concept_coach_jose_guillen	concept_sport_hockey
concept_coach_jose_theodore	concept_sport_hockey
concept_coach_josef_vasicek	concept_sport_hockey
concept_coach_josh_hamilton	concept_sport_baseball
concept_coach_justin_miller	concept_sport_football
concept_coach_justin_pogge	concept_sport_hockey
concept_coach_ken_dye	concept_sport_hockey
concept_coach_kenny_rogers	concept_sport_baseball
concept_coach_kerry_collins	concept_sport_football
concept_coach_kerry_collins	concept_sport_hockey
concept_coach_kevin_love	concept_sport_softball
concept_coach_kevin_slowey	concept_sport_baseball
concept_coach_kevin_youkilis	concept_sport_baseball
concept_coach_kip_wells	concept_sport_hockey
concept_coach_koyie_hill	concept_sport_hockey
concept_coach_kris_letang	concept_sport_hockey
concept_coach_kyle_kendrick	concept_sport_baseball
concept_coach_kyle_okposo	concept_sport_hockey
concept_coach_kyle_wellwood	concept_sport_hockey
concept_coach_ladainian_tomlinson	concept_sport_football
concept_coach_lamarr_woodley	concept_sport_football
concept_coach_lance_briggs	concept_sport_football
concept_coach_laveranues_coles	concept_sport_football
concept_coach_lawrence_tynes	concept_sport_football
concept_coach_lebron_james	concept_sport_basketball
concept_coach_lendale_white	concept_sport_football
concept_coach_lendale_white	concept_sport_hockey
concept_coach_lenny_moore	concept_sport_football
concept_coach_leodis_mckelvin	concept_sport_football
concept_coach_linehan	concept_sport_football
concept_coach_losman	concept_sport_football
concept_coach_losman	concept_sport_hockey
concept_coach_loui_eriksson	concept_sport_hockey
concept_coach_lubomir_visnovsky	concept_sport_hockey
concept_coach_luke_hudson	concept_sport_baseball
concept_coach_luke_schenn	concept_sport_hockey
concept_coach_manny_legace	concept_sport_hockey
concept_coach_marc_andre_fleury	concept_sport_hockey
concept_coach_marcin_gortat	concept_sport_basketball
concept_coach_marco_sturm	concept_sport_hockey
concept_coach_marion_barber_iii	concept_sport_football
concept_coach_mark_grudzielanek	concept_sport_baseball
concept_coach_mark_grudzielanek	concept_sport_hockey
concept_coach_mark_parrish	concept_sport_hockey
concept_coach_mark_recchi	concept_sport_football
concept_coach_mark_streit	concept_sport_hockey
concept_coach_marshall_faulk	concept_sport_football
concept_coach_martz	concept_sport_football
concept_coach_marvin_lewis	concept_sport_football
concept_coach_matt_forte	concept_sport_football
concept_coach_matt_holiday	concept_sport_baseball
concept_coach_matt_stairs	concept_sport_baseball
concept_coach_matt_stajan	concept_sport_hockey
concept_coach_matthew_lombardi	concept_sport_hockey
concept_coach_maurice_jones_drew	concept_sport_football
concept_coach_maurice_jones_drew	concept_sport_hockey
concept_coach_maxim_afinogenov	concept_sport_hockey
concept_coach_michael_bourn	concept_sport_baseball
concept_coach_michael_frolik	concept_sport_football
concept_coach_michael_nylander	concept_sport_hockey
concept_coach_mickael_pietrus	concept_sport_basketball
concept_coach_mickey_mantle	concept_sport_baseball
concept_coach_mike_comrie	concept_sport_hockey
concept_coach_mike_ditka	concept_sport_football
concept_coach_mike_fontenot	concept_sport_baseball
concept_coach_mike_holmgren	concept_sport_football
concept_coach_mike_martz	concept_sport_football
concept_coach_mike_mularkey	concept_sport_football
concept_coach_mike_sillinger	concept_sport_hockey
concept_coach_mike_tomlin	concept_sport_football
concept_coach_mikhail_grabovski	concept_sport_hockey
concept_coach_milan_hejduk	concept_sport_hockey
concept_coach_milan_lucic	concept_sport_hockey
concept_coach_nate_mclouth	concept_sport_baseball
concept_coach_nate_mclouth	concept_sport_hockey
concept_coach_nathan_horton	concept_sport_football
concept_coach_nik_antropov	concept_sport_hockey
concept_coach_niklas_hagman	concept_sport_hockey
concept_coach_nikolai_zherdev	concept_sport_hockey
concept_coach_nnamdi_asomugha	concept_sport_football
concept_coach_olaf_kolzig	concept_sport_football
concept_coach_ozzie_guillen	concept_sport_baseball
concept_coach_p_j__brown	concept_sport_football
concept_coach_p_j__carlesimo	concept_sport_football
concept_coach_p_j__hill	concept_sport_football
concept_coach_pascal_leclaire	concept_sport_hockey
concept_coach_patrick_kane	concept_sport_hockey
concept_coach_patrick_pinkney	concept_sport_baseball
concept_coach_patrik_elias	concept_sport_hockey
concept_coach_paul_martin	concept_sport_hockey
concept_coach_paul_maurice	concept_sport_hockey
concept_coach_pedro_martinez	concept_sport_baseball
concept_coach_peter_moylan	concept_sport_hockey
concept_coach_phil_jackson	concept_sport_basketball
concept_coach_philip_rivers	concept_sport_football
concept_coach_pj_hill	concept_sport_football
concept_coach_pronger	concept_sport_hockey
concept_coach_randor_bierd	concept_sport_baseball
concept_coach_rex_grossman	concept_sport_football
concept_coach_rich_brooks	concept_sport_football
concept_coach_richard_hamilton	concept_sport_basketball
concept_coach_richard_zednik	concept_sport_football
concept_coach_robyn_regehr	concept_sport_hockey
concept_coach_roger_staubach	concept_sport_football
concept_coach_romeo_crennel	concept_sport_football
concept_coach_ryan_fitzpatrick	concept_sport_baseball
concept_coach_ryan_fitzpatrick	concept_sport_football
concept_coach_sami_salo	concept_sport_hockey
concept_coach_sammy_sosa	concept_sport_baseball
concept_coach_scott_linehan	concept_sport_football
concept_coach_seneca_wallace	concept_sport_football
concept_coach_sergei_fedorov	concept_sport_hockey
concept_coach_sergei_gonchar	concept_sport_hockey
concept_coach_sergei_kostitsyn	concept_sport_hockey
concept_coach_seth_smith	concept_sport_baseball
concept_coach_shaun_alexander	concept_sport_football
concept_coach_shea_weber	concept_sport_hockey
concept_coach_sidney_crosby_and_evgeni_malkin	concept_sport_hockey
concept_coach_steve_mcnair	concept_sport_football
concept_coach_steve_mcnair	concept_sport_hockey
concept_coach_steve_montador	concept_sport_hockey
concept_coach_steve_spagnuolo	concept_sport_football
concept_coach_steve_staios	concept_sport_hockey
concept_coach_steven_jackson	concept_sport_football
concept_coach_steven_stamkos	concept_sport_football
concept_coach_t_j__houshmandzadeh	concept_sport_football
concept_coach_t_j_galiardi	concept_sport_football
concept_coach_takeo_spikes	concept_sport_football
concept_coach_tarvaris_jackson	concept_sport_football
concept_coach_teppo_numminen	concept_sport_hockey
concept_coach_terrell_suggs	concept_sport_football
concept_coach_thomas_vanek	concept_sport_hockey
concept_coach_tim_jackman	concept_sport_hockey
concept_coach_todd_bertuzzi	concept_sport_hockey
concept_coach_tom_coughlin	concept_sport_football
concept_coach_tom_kostopoulos	concept_sport_hockey
concept_coach_tomas_kaberle	concept_sport_hockey
concept_coach_tomas_plekanec	concept_sport_hockey
concept_coach_tony_dungy	concept_sport_football
concept_coach_tony_fernandez	concept_sport_baseball
concept_coach_tony_la_russa	concept_sport_baseball
concept_coach_tony_sipp	concept_sport_hockey
concept_coach_torry_holt	concept_sport_football
concept_coach_trent_edwards	concept_sport_football
concept_coach_tyler_kennedy	concept_sport_hockey
concept_coach_van_note	concept_sport_baseball
concept_coach_van_note	concept_sport_hockey
concept_coach_vesa_toskala	concept_sport_hockey
concept_coach_vince_carter	concept_sport_basketball
concept_coach_vince_lombardi	concept_sport_football
concept_coach_vince_young	concept_sport_football
concept_coach_vince_young	concept_sport_hockey
concept_coach_vincent_lecavalier	concept_sport_hockey
concept_coach_wade_dubielewicz	concept_sport_hockey
concept_coach_warrick_dunn	concept_sport_football
concept_coach_wendel_clark	concept_sport_hockey
concept_coach_willis_mcgahee	concept_sport_football
concept_coach_wojtek_wolski	concept_sport_hockey
concept_coach_yorvit_torrealba	concept_sport_baseball
concept_coach_zdeno_chara	concept_sport_hockey
concept_coach_zidane	concept_sport_golf
concept_coach_zidane	concept_sport_tennis
concept_male_alex_rodriguez	concept_sport_baseball
concept_male_allen_iverson	concept_sport_basketball
concept_male_daniel_ewing	concept_sport_basketball
concept_male_darryl_strawberry	concept_sport_baseball
concept_male_gerald_green	concept_sport_basketball
concept_male_jermaine_dye	concept_sport_baseball
concept_male_joakim_noah	concept_sport_basketball
concept_male_kevin_garnett	concept_sport_basketball
concept_male_michael_barrett	concept_sport_baseball
concept_male_richard_jefferson	concept_sport_football
concept_male_steve_garvey	concept_sport_baseball
concept_male_yogi_berra	concept_sport_baseball
concept_person_tebow	concept_sport_basketball
concept_personafrica_brian_mccann	concept_sport_baseball
concept_personasia_andre_miller	concept_sport_basketball
concept_personasia_anthony_grundy	concept_sport_basketball
concept_personasia_chien_ming_wang	concept_sport_baseball
concept_personasia_daniel_alfredsson	concept_sport_hockey
concept_personasia_rick_ankiel	concept_sport_baseball
concept_personaustralia_brian_mcbride	concept_sport_soccer
concept_personaustralia_elano	concept_sport_golf
concept_personaustralia_gary_neville	concept_sport_basketball
concept_personaustralia_jack_johnson	concept_sport_hockey
concept_personaustralia_joe_johnson	concept_sport_basketball
concept_personaustralia_john_danks	concept_sport_baseball
concept_personaustralia_josh_johnson	concept_sport_baseball
concept_personaustralia_kris_boyd	concept_sport_hockey
concept_personaustralia_lee_mcculloch	concept_sport_hockey
concept_personaustralia_lukas_podolski	concept_sport_golf
concept_personaustralia_michael_owen	concept_sport_football
concept_personaustralia_smith	concept_sport_football
concept_personcanada_brenden_morrow	concept_sport_hockey
concept_personcanada_robert_lang	concept_sport_hockey
concept_personeurope_daniel_paille	concept_sport_hockey
concept_personeurope_david_beckham	concept_sport_basketball
concept_personeurope_fernando_torres	concept_sport_football
concept_personeurope_marian_hossa	concept_sport_hockey
concept_personeurope_owen_hargreaves	concept_sport_basketball
concept_personeurope_robbie_fowler	concept_sport_football
concept_personmexico_a_j__murray	concept_sport_baseball
concept_personmexico_adam_dunn	concept_sport_baseball
concept_personmexico_adam_everett	concept_sport_baseball
concept_personmexico_alexander_ovechkin	concept_sport_hockey
concept_personmexico_alexi_casilla	concept_sport_baseball
concept_personmexico_alfonso_soriano	concept_sport_baseball
concept_personmexico_anthony_reyes001	concept_sport_baseball
concept_personmexico_bobby_murcer	concept_sport_baseball
concept_personmexico_brandon_jacobs	concept_sport_football
concept_personmexico_brendan_harris	concept_sport_baseball
concept_personmexico_brian_brohm	concept_sport_football
concept_personmexico_brian_leetch	concept_sport_hockey
concept_personmexico_carlos_g_mez	concept_sport_baseball
concept_personmexico_carlos_santana001	concept_sport_baseball
concept_personmexico_chris_chambers	concept_sport_football
concept_personmexico_chris_neil	concept_sport_hockey
concept_personmexico_cody_ross	concept_sport_baseball
concept_personmexico_craig_counsell	concept_sport_baseball
concept_personmexico_craig_smith	concept_sport_basketball
concept_personmexico_daisuke_matsuzaka	concept_sport_baseball
concept_personmexico_daniel_carcillo	concept_sport_baseball
concept_personmexico_david_dejesus	concept_sport_hockey
concept_personmexico_david_tyree	concept_sport_football
concept_personmexico_david_wright	concept_sport_baseball
concept_personmexico_fabricio_oberto	concept_sport_basketball
concept_personmexico_felix_jones	concept_sport_football
concept_personmexico_francisco_rodr_guez	concept_sport_baseball
concept_personmexico_gerald_laird	concept_sport_hockey
concept_personmexico_gregg_zaun	concept_sport_baseball
concept_personmexico_hideki_matsui	concept_sport_baseball
concept_personmexico_jack_wilson	concept_sport_baseball
concept_personmexico_jack_wilson	concept_sport_hockey
concept_personmexico_jamaal_anderson001	concept_sport_football
concept_personmexico_jamal_lewis	concept_sport_football
concept_personmexico_jamie_langenbrunner	concept_sport_hockey
concept_personmexico_jason_bartlett	concept_sport_hockey
concept_personmexico_jason_giambi	concept_sport_baseball
concept_personmexico_jason_kubel	concept_sport_baseball
concept_personmexico_jason_spezza	concept_sport_hockey
concept_personmexico_jason_taylor	concept_sport_football
concept_personmexico_jon_rauch	concept_sport_baseball
concept_personmexico_jonathan_van_every	concept_sport_baseball
concept_personmexico_jonathan_vilma	concept_sport_football
concept_personmexico_jorge_posada	concept_sport_baseball
concept_personmexico_jose_castillo	concept_sport_football
concept_personmexico_jose_molina	concept_sport_baseball
concept_personmexico_josh_anderson001	concept_sport_baseball
concept_personmexico_josh_beckett	concept_sport_baseball
concept_personmexico_josh_willingham	concept_sport_baseball
concept_personmexico_juan_pie	concept_sport_baseball
concept_personmexico_julio_franco	concept_sport_baseball
concept_personmexico_julius_jones	concept_sport_football
concept_personmexico_lastings_milledge	concept_sport_baseball
concept_personmexico_luis_gonzalez	concept_sport_baseball
concept_personmexico_luke_walton	concept_sport_basketball
concept_personmexico_lynn_swann	concept_sport_football
concept_personmexico_manny_malhotra	concept_sport_hockey
concept_personmexico_manny_ramirez	concept_sport_baseball
concept_personmexico_mark_buehrle	concept_sport_baseball
concept_personmexico_matt_diaz	concept_sport_baseball
concept_personmexico_matt_flynn001	concept_sport_hockey
concept_personmexico_matt_kemp	concept_sport_baseball
concept_personmexico_melky_cabrera	concept_sport_baseball
concept_personmexico_miguel_cabrera	concept_sport_baseball
concept_personmexico_miguel_tejada	concept_sport_baseball
concept_personmexico_mookie_wilson	concept_sport_baseball
concept_personmexico_patrick_roy	concept_sport_hockey
concept_personmexico_paul_kariya	concept_sport_hockey
concept_personmexico_ronny_paulino	concept_sport_baseball
concept_personmexico_ronny_paulino	concept_sport_hockey
concept_personmexico_ryan_church	concept_sport_baseball
concept_personmexico_scott_thorman	concept_sport_baseball
concept_personmexico_sean_marshall	concept_sport_baseball
concept_personmexico_shaun_marcum	concept_sport_baseball
concept_personmexico_shaun_marcum	concept_sport_basketball
concept_personmexico_todd_coffey	concept_sport_baseball
concept_personmexico_tommie_agee	concept_sport_baseball
concept_personmexico_vladimir_guerrero	concept_sport_baseball
concept_personmexico_zach_duke	concept_sport_baseball
concept_personmexico_zach_duke	concept_sport_hockey
concept_personnorthamerica_michael_turner	concept_sport_football
concept_personus_ian_kinsler	concept_sport_hockey
concept_personus_jackie_robinson	concept_sport_baseball
concept_personus_jeremy_shockey	concept_sport_football
concept_personus_kobe_bryant	concept_sport_basketball
concept_personus_lance_berkman	concept_sport_baseball
concept_personus_miller	concept_sport_hockey
concept_personus_orlando_hudson	concept_sport_baseball
concept_personus_roy_oswalt	concept_sport_baseball
concept_visualizablething_vermeil	concept_sport_football
