concept_automobilemaker_caterpillar	concept_city_peoria
concept_automobilemaker_chrysler_group	concept_city_auburn_hills
concept_automobilemaker_chrysler_llc	concept_city_auburn_hills
concept_automobilemaker_fiat	concept_city_auburn_hills
concept_automobilemaker_fiat_spa	concept_city_auburn_hills
concept_automobilemaker_ford	concept_city_dearborn
concept_automobilemaker_gm	concept_city_detroit
concept_bank_american_express	concept_city_new_york
concept_bank_australia_and_new_zealand_banking_group	concept_city_melbourne
concept_bank_bbva	concept_city_bilbao
concept_bank_capitol	concept_city_seattle
concept_bank_citigroup	concept_city_new_york
concept_bank_citigroup_global_markets	concept_city_new_york
concept_bank_federal_reserve	concept_city_washington_d_c
concept_bank_ge	concept_city_fairfield
concept_bank_general_electric	concept_city_fairfield
concept_bank_goldman	concept_city_new_york
concept_bank_imf_world_bank	concept_city_washington_d_c
concept_bank_lehman_brothers	concept_city_new_york
concept_bank_morgan_stanley	concept_city_new_york
concept_bank_prudential_financial	concept_city_newark
concept_bank_ups	concept_city_atlanta
concept_bank_us_airways	concept_city_baltimore
concept_bank_viacom	concept_city_new_york
concept_bank_world_bank	concept_city_washington_d_c
concept_biotechcompany_alcoa	concept_city_pittsburgh
concept_biotechcompany_allergan	concept_city_irvine
concept_biotechcompany_apple	concept_city_cupertino
concept_biotechcompany_archer_daniels_midland	concept_city_decatur
concept_biotechcompany_baxter	concept_city_deerfield
concept_biotechcompany_boeing	concept_city_chicago
concept_biotechcompany_boeing_co	concept_city_chicago
concept_biotechcompany_boeing_commercial_airplanes	concept_city_chicago
concept_biotechcompany_cisco	concept_city_san_jose
concept_biotechcompany_cisco_systems_inc	concept_city_san_jose
concept_biotechcompany_cisco_systems_inc_	concept_city_san_jose
concept_biotechcompany_citigroup_inc	concept_city_new_york
concept_biotechcompany_comcast	concept_city_philadelphia
concept_biotechcompany_conocophillips	concept_city_houston
concept_biotechcompany_dow	concept_city_midland
concept_biotechcompany_dow_chemical	concept_city_midland
concept_biotechcompany_dow_chemical_co_	concept_city_midland
concept_biotechcompany_duke_energy_corporation	concept_city_charlotte
concept_biotechcompany_eastman_chemical	concept_city_kingsport
concept_biotechcompany_eastman_kodak	concept_city_rochester
concept_biotechcompany_eli_lilly	concept_city_indianapolis
concept_biotechcompany_forest	concept_city_san_francisco
concept_biotechcompany_h_j__heinz	concept_city_pittsburgh
concept_biotechcompany_honeywell	concept_city_morristown
concept_biotechcompany_infosys_technologies	concept_city_bangalore
concept_biotechcompany_intel_corp	concept_city_santa_clara
concept_biotechcompany_lockheed_martin	concept_city_bethesda
concept_biotechcompany_mallinckrodt	concept_city_st_louis
concept_biotechcompany_merck	concept_city_rahway
concept_biotechcompany_merck___co	concept_city_rahway
concept_biotechcompany_microsoft__	concept_city_redmond
concept_biotechcompany_microsoft_corp	concept_city_redmond
concept_biotechcompany_nokia_siemens	concept_city_espoo
concept_biotechcompany_pfizer	concept_city_new_york
concept_biotechcompany_roche	concept_city_nutley
concept_biotechcompany_sigma	concept_city_st_louis
concept_biotechcompany_the_walt_disney_co_	concept_city_burbank
concept_biotechcompany_unicef	concept_city_new_york
concept_biotechcompany_wal_mart_stores	concept_city_bentonville
concept_biotechcompany_whirlpool_corporation	concept_city_benton_harbor
concept_blog_america_online	concept_city_new_york
concept_blog_business_week	concept_city_new_york
concept_blog_mtv	concept_city_new_york
concept_blog_slashdot	concept_city_new_york
concept_blog_time_out_new_york	concept_city_new_york
concept_blog_time_warner	concept_city_new_york
concept_company_aarp	concept_city_washington_d_c
concept_company_about_com	concept_city_new_york
concept_company_actors	concept_city_new_york
concept_company_adm_	concept_city_decatur
concept_company_aer_arann	concept_city_galway
concept_company_aeroflot	concept_city_moscow
concept_company_aerolineas_argentinas	concept_city_buenos_aires
concept_company_aflac	concept_city_columbus
concept_company_air_astana	concept_city_almaty
concept_company_air_berlin	concept_city_berlin
concept_company_air_china	concept_city_beijing
concept_company_air_france	concept_city_toronto
concept_company_air_india	concept_city_bombay
concept_company_air_namibia	concept_city_windhoek
concept_company_air_niugini	concept_city_port_moresby
concept_company_air_tahiti	concept_city_papeete
concept_company_air_zimbabwe	concept_city_harare
concept_company_airtran_airways	concept_city_atlanta
concept_company_ala	concept_city_washington_d_c
concept_company_alaska_airlines	concept_city_seattle
concept_company_allegiant	concept_city_las_vegas
concept_company_allstate	concept_city_northbrook
concept_company_anheuser_busch_companies	concept_city_st_louis
concept_company_anheuser_busch_companies001	concept_city_st_louis
concept_company_aol	concept_city_new_york
concept_company_ap_	concept_city_new_york
concept_company_ap_001	concept_city_washington_d_c
concept_company_apple002	concept_city_london_city
concept_company_asylum	concept_city_hartford
concept_company_atlas_blue	concept_city_nador
concept_company_austrian_airlines	concept_city_vienna
concept_company_avianca	concept_city_bogota
concept_company_bahamas_air	concept_city_nassau
concept_company_battelle	concept_city_columbus
concept_company_beacon	concept_city_boston
concept_company_bloomberg	concept_city_new_york
concept_company_burger_king_hldgs	concept_city_miami
concept_company_cable_tv_companies	concept_city_new_york
concept_company_capital	concept_city_washington_dc
concept_company_capital_one_financial	concept_city_mclean
concept_company_capitol	concept_city_washington_dc
concept_company_carnival	concept_city_miami
concept_company_carnival_cruises	concept_city_miami
concept_company_cbs_corp_	concept_city_new_york
concept_company_century_regional_detention_center	concept_city_lynwood
concept_company_cherry	concept_city_baltimore
concept_company_chevron001	concept_city_san_ramon
concept_company_china_eastern_airlines	concept_city_shanghai
concept_company_china_southern	concept_city_guangzhou
concept_company_chronicle001	concept_county_los_angeles_county
concept_company_chrysler	concept_city_auburn_hills
concept_company_chrysler_llc__	concept_city_auburn_hills
concept_company_citicorp	concept_city_new_york
concept_company_city_paper001	concept_city_washington_d_c
concept_company_clinton	concept_city_brooklyn
concept_company_cnbc	concept_city_new_york
concept_company_cnn	concept_city_atlanta
concept_company_cnn_	concept_city_washington_d_c
concept_company_cnn__pbs	concept_city_new_york
concept_company_comcast	concept_city_new_york
concept_company_comcast_cable	concept_city_new_york
concept_company_companies	concept_city_new_york
concept_company_consolidated_edison	concept_city_new_york
concept_company_continental	concept_city_houston
concept_company_continental_airlines001	concept_city_houston
concept_company_court_tv	concept_city_new_york
concept_company_cramer	concept_city_camden
concept_company_croatia_airlines	concept_city_zagreb
concept_company_cubana	concept_city_havana
concept_company_daily_news001	concept_county_los_angeles_county
concept_company_deere	concept_city_moline
concept_company_delta	concept_city_atlanta
concept_company_directv001	concept_city_new_york
concept_company_dish_network_and_directv	concept_city_new_york
concept_company_disney	concept_city_burbank
concept_company_disney_feature_animation	concept_city_burbank
concept_company_dow_jones	concept_city_new_york
concept_company_dow_jones_indexes	concept_city_new_york
concept_company_dragonair	concept_city_hong_kong_island
concept_company_druk_air	concept_city_paro
concept_company_eastman	concept_city_kingsport
concept_company_ebay002	concept_city_san_jose
concept_company_edge	concept_city_liverpool
concept_company_eds	concept_city_plano
concept_company_emc001	concept_city_hopkinton
concept_company_espn_com	concept_city_new_york
concept_company_esquire	concept_city_new_york
concept_company_ethiopian_airlines	concept_city_addis_ababa
concept_company_examiner	concept_county_los_angeles_county
concept_company_fcc	concept_city_washington_d_c
concept_company_fda	concept_city_rockville
concept_company_fema	concept_city_washington_d_c
concept_company_ford_foundation	concept_city_dearborn
concept_company_ford_motor	concept_city_dearborn
concept_company_ford_motor_company	concept_city_dearborn
concept_company_ford_motor_credit	concept_city_dearborn
concept_company_fox	concept_city_new_york
concept_company_fox_network	concept_city_new_york
concept_company_frontier	concept_city_denver
concept_company_general	concept_city_rawalpindi
concept_company_general_dynamics	concept_city_falls_church
concept_company_general_mills001	concept_city_minneapolis
concept_company_general_motors	concept_city_detroit
concept_company_general_motors001	concept_city_detroit
concept_company_georgia_pacific	concept_city_atlanta
concept_company_glsen	concept_city_new_york
concept_company_goldman_sachs001	concept_city_new_york
concept_company_good_morning_america001	concept_city_new_york
concept_company_hearst	concept_city_new_york
concept_company_heritage	concept_city_grand_rapids_kalamazoo_battle_creek
concept_company_hindustan_unilever	concept_city_bombay
concept_company_horizon	concept_city_seattle
concept_company_hp	concept_city_palo_alto
concept_company_hp_	concept_city_palo_alto
concept_company_iberia	concept_city_madrid
concept_company_imf	concept_city_prague
concept_company_imf001	concept_city_washington_d_c
concept_company_ingram_micro	concept_city_santa_ana
concept_company_international_monetary_fund	concept_city_washington_d_c
concept_company_international_steel_group	concept_city_cleveland
concept_company_irs	concept_city_washington_d_c
concept_company_johnson_controls	concept_city_milwaukee
concept_company_kenya_airways	concept_city_nairobi
concept_company_kroger	concept_city_cincinnati
concept_company_lg	concept_city_seoul
concept_company_malaysian	concept_city_kuala_lumpur
concept_company_management	concept_city_washington_d_c
concept_company_marriott_international001	concept_city_bethesda
concept_company_martha_stewart	concept_city_new_york
concept_company_mcdonald_s001	concept_city_oak_brook
concept_company_metlife	concept_city_new_york
concept_company_micron	concept_city_boise
concept_company_micron_technology	concept_city_boise
concept_company_microsoft_corporation	concept_city_redmond
concept_company_microsoft_corporation001	concept_city_redmond
concept_company_miller_brewing	concept_city_milwaukee
concept_company_msnbc	concept_city_new_york
concept_company_murray	concept_island_manhattan
concept_company_nasdaq	concept_city_new_york
concept_company_nation	concept_city_new_york
concept_company_national_city	concept_city_cleveland
concept_company_national_public_radio	concept_city_washington_d_c
concept_company_national_public_radio001	concept_city_new_york
concept_company_nature_air	concept_city_san_jose
concept_company_nbc	concept_city_new_york
concept_company_new_york_life_insurance	concept_city_new_york
concept_company_nokia	concept_city_espoo
concept_company_npr	concept_city_washington_d_c
concept_company_ntt	concept_city_tokyo
concept_company_observer001	concept_city_washington_d_c
concept_company_olympic	concept_city_new_york
concept_company_owens_corning	concept_city_sydney
concept_company_pbs	concept_city_new_york
concept_company_pembina_institute	concept_city_calgary
concept_company_phillips	concept_city_bartlesville
concept_company_phillips_petroleum	concept_city_bartlesville
concept_company_pixar	concept_city_emeryville
concept_company_pixar_animation_studios	concept_city_emeryville
concept_company_playboy_enterprises	concept_city_new_york
concept_company_post	concept_county_los_angeles_county
concept_company_press	concept_city_washington_d_c
concept_company_price	concept_city_cincinnati
concept_company_prudential001	concept_city_newark
concept_company_quds_force	concept_city_tehran
concept_company_qwest	concept_city_denver
concept_company_qwest_communications	concept_city_denver
concept_company_qwest_communications_international	concept_city_denver
concept_company_raytheon001	concept_county_lexington
concept_company_red_hat_inc	concept_city_durham
concept_company_red_hat_software	concept_city_durham
concept_company_reebok	concept_city_canton
concept_company_revolution_health_com	concept_city_new_york
concept_company_revolution_health_group	concept_city_new_york
concept_company_rose	concept_city_kirkland
concept_company_royal_air_maroc	concept_city_casablanca
concept_company_ryanair	concept_city_glasgow
concept_company_sabritas	concept_city_mexico_city
concept_company_safeco	concept_city_seattle
concept_company_salon	concept_city_new_york
concept_company_samsung	concept_city_seoul
concept_company_sas	concept_city_heathrow
concept_company_savin	concept_city_dorchester
concept_company_seattle_p_i	concept_city_seattle
concept_company_smithsonian	concept_city_washington_dc
concept_company_spirit	concept_city_fort_lauderdale
concept_company_sprint001	concept_county_kansas_city
concept_company_sprint_nextel	concept_county_kansas_city
concept_company_srilankan	concept_city_colombo
concept_company_state_farm_insurance	concept_city_bloomington
concept_company_sugar	concept_city_harlem
concept_company_sun	concept_city_washington_d_c
concept_company_swagelok	concept_city_solon
concept_company_swiss_re	concept_city_london_city
concept_company_taco_bell	concept_city_irvine
concept_company_thai_air_asia	concept_city_bangkok
concept_company_the_new_york_times001	concept_city_washington_d_c
concept_company_tiaa_cref	concept_city_new_york
concept_company_tiffany	concept_city_new_york
concept_company_time_warner	concept_city_oh
concept_company_tjx	concept_city_framingham
concept_company_today_show	concept_city_new_york
concept_company_toro	concept_city_bloomington
concept_company_turkish_airlines	concept_city_istanbul
concept_company_usda	concept_city_washington_d_c
concept_company_village_voice_media	concept_city_new_york
concept_company_virgin	concept_city_heathrow
concept_company_virgin_blue	concept_city_brisbane
concept_company_voa	concept_city_washington_d_c
concept_company_wal_mart	concept_city_bentonville
concept_company_wall_street_journal_interactive_edition	concept_city_new_york
concept_company_walt_disney	concept_city_burbank
concept_company_walt_disney_world	concept_city_burbank
concept_company_walt_disney_world_resort	concept_city_burbank
concept_company_warner_bros_	concept_city_burbank
concept_company_wb	concept_city_washington_d_c
concept_company_weekly_standard001	concept_city_washington_d_c
concept_company_westjet	concept_city_calgary
concept_company_weyerhaeuser	concept_city_federal_way
concept_company_winter	concept_city_somerville
concept_company_wipo	concept_city_geneva
concept_company_world_meteorological_organization	concept_city_geneva
concept_company_wto001	concept_city_geneva
concept_company_wwe	concept_city_stamford
concept_company_wyeth	concept_city_madison
concept_magazine_national_geographic_magazine	concept_city_washington_d_c
concept_magazine_sports_illustrated	concept_city_new_york
concept_magazine_vogue	concept_city_new_york
concept_newspaper_business_journal	concept_city_washington_d_c
concept_newspaper_chronicle	concept_city_new_york
concept_newspaper_enquirer	concept_city_new_york
concept_newspaper_financial_times	concept_city_london_city
concept_newspaper_herald	concept_county_los_angeles_county
concept_newspaper_inquirer	concept_city_new_york
concept_newspaper_journal	concept_city_new_york
concept_newspaper_law_journal	concept_city_new_york
concept_newspaper_national_enquirer	concept_city_new_york
concept_newspaper_national_review	concept_city_new_york
concept_newspaper_national_review_online	concept_city_new_york
concept_newspaper_new_york_observer	concept_city_new_york
concept_newspaper_new_york_post	concept_city_new_york
concept_newspaper_new_york_sun	concept_city_new_york
concept_newspaper_record	concept_city_new_york
concept_newspaper_seattle_pi	concept_city_seattle
concept_newspaper_seattle_post_intelligencer	concept_city_seattle
concept_newspaper_the_guardian	concept_city_london_city
concept_newspaper_the_national	concept_city_washington_d_c
concept_newspaper_the_new_yorker	concept_city_new_york
concept_newspaper_the_voice	concept_city_new_york
concept_newspaper_the_wall_street	concept_city_new_york
concept_newspaper_times	concept_city_washington_d_c
concept_newspaper_tribune	concept_city_new_york
concept_newspaper_u_s__news_and_world_report	concept_city_new_york
concept_newspaper_wall_street_journal	concept_city_new_york
concept_organization_carnival_cruise_lines	concept_city_miami
concept_politicsblog_amazon_com	concept_city_seattle
concept_politicsblog_huffington_post	concept_city_new_york
concept_politicsblog_journal	concept_city_washington_d_c
concept_politicsblog_the_american	concept_city_new_york
concept_politicsblog_tribune	concept_city_washington_d_c
concept_politicsblog_wall_street_journal	concept_city_washington_d_c
concept_publication_artforum	concept_city_new_york
concept_publication_espn	concept_city_new_york
concept_publication_national_press	concept_city_washington_d_c
concept_publication_new_york_lawyer	concept_city_new_york
concept_publication_slate	concept_city_new_york
concept_publication_telegraph	concept_city_san_francisco
concept_publication_the_new_york_review_of_books	concept_city_new_york
concept_publication_times_book_review	concept_city_new_york
concept_publication_times_literary_supplement	concept_city_new_york
concept_publication_vanity_fair	concept_city_new_york
concept_publication_variety	concept_city_new_york
concept_radiostation_chum	concept_city_toronto
concept_radiostation_ciut	concept_city_toronto
concept_radiostation_cklw	concept_city_windsor
concept_radiostation_ckut	concept_city_montreal
concept_radiostation_kaat	concept_city_oakhurst
concept_radiostation_kabc	concept_county_los_angeles_county
concept_radiostation_kalw	concept_city_san_francisco
concept_radiostation_kalx	concept_city_berkeley
concept_radiostation_kasu	concept_city_jonesboro
concept_radiostation_kaxe	concept_city_grand_rapids_kalamazoo_battle_creek
concept_radiostation_kbco	concept_city_boulder
concept_radiostation_kbia	concept_city_columbia
concept_radiostation_kboo	concept_city_portland
concept_radiostation_kbsg_fm	concept_city_tacoma
concept_radiostation_kbsu	concept_city_boise
concept_radiostation_kcbs	concept_city_san_francisco
concept_radiostation_kcbx	concept_city_san_luis_obispo
concept_radiostation_kcms_fm	concept_city_edmonds
concept_radiostation_kcmu	concept_city_seattle
concept_radiostation_kcpq_tv	concept_city_tacoma
concept_radiostation_kcrw	concept_city_santa_monica
concept_radiostation_kcsb	concept_city_santa_barbara_de_nexe
concept_radiostation_kcsm	concept_city_san_mateo
concept_radiostation_kcsn	concept_city_northridge
concept_radiostation_kcty	concept_city_salinas
concept_radiostation_kdhx	concept_city_st__louis
concept_radiostation_kdka	concept_city_pittsburgh
concept_radiostation_kdnk	concept_city_carbondale
concept_radiostation_kdur	concept_city_durango
concept_radiostation_ketr	concept_city_commerce
concept_radiostation_kex	concept_city_portland
concept_radiostation_kexp	concept_city_seattle
concept_radiostation_kfai	concept_city_minneapolis
concept_radiostation_kfbk	concept_city_sacramento
concept_radiostation_kfi	concept_county_los_angeles_county
concept_radiostation_kfog	concept_city_san_francisco
concept_radiostation_kfsk	concept_city_petersburg
concept_radiostation_kfwb	concept_county_los_angeles_county
concept_radiostation_kgmi	concept_city_bellingham
concept_radiostation_kgnu	concept_city_boulder
concept_radiostation_kgrg_fm	concept_city_auburn
concept_radiostation_khow	concept_city_denver
concept_radiostation_khsu	concept_city_arcata
concept_radiostation_kiis	concept_county_los_angeles_county
concept_radiostation_kimn	concept_city_denver
concept_radiostation_king_fm	concept_city_seattle
concept_radiostation_kios	concept_city_omaha
concept_radiostation_kiro_am	concept_city_seattle
concept_radiostation_kisw	concept_city_seattle
concept_radiostation_kisw_fm	concept_city_seattle
concept_radiostation_kixi_am	concept_city_mercer_island
concept_radiostation_kjr	concept_city_seattle
concept_radiostation_kjr_am	concept_city_seattle
concept_radiostation_kkbt	concept_county_los_angeles_county
concept_radiostation_kkjz	concept_city_long_beach
concept_radiostation_klcc	concept_city_eugene
concept_radiostation_klos	concept_county_los_angeles_county
concept_radiostation_klsx	concept_county_los_angeles_county
concept_radiostation_klsy_fm	concept_city_bellevue
concept_radiostation_kmox	concept_city_st_louis
concept_radiostation_kmps_fm	concept_city_seattle
concept_radiostation_kmud	concept_city_garberville
concept_radiostation_kmuw	concept_city_wichita
concept_radiostation_knba	concept_city_anchorage
concept_radiostation_knbr	concept_city_san_francisco
concept_radiostation_knhm	concept_city_bayside
concept_radiostation_knon	concept_city_dallas
concept_radiostation_knpr	concept_city_las_vegas
concept_radiostation_knx	concept_county_los_angeles_county
concept_radiostation_kogo	concept_city_san_diego
concept_radiostation_kola	concept_city_redlands
concept_radiostation_komo_tv	concept_city_seattle
concept_radiostation_kong_tv	concept_city_everett
concept_radiostation_koop	concept_city_austin
concept_radiostation_kopn	concept_city_columbia
concept_radiostation_kosu	concept_city_stillwater
concept_radiostation_koto	concept_city_telluride
concept_radiostation_kpbs	concept_city_san_diego
concept_radiostation_kpbx	concept_city_spokane
concept_radiostation_kpcc	concept_city_pasadena
concept_radiostation_kpfa	concept_city_berkeley
concept_radiostation_kpfk	concept_county_los_angeles_county
concept_radiostation_kpft	concept_city_houston
concept_radiostation_kplu_fm	concept_city_tacoma
concept_radiostation_kplz_fm	concept_city_seattle
concept_radiostation_kpoo	concept_city_san_francisco
concept_radiostation_kprl	concept_city_paso_robles
concept_radiostation_kqed	concept_city_san_francisco
concept_radiostation_kqv	concept_city_pittsburgh
concept_radiostation_krbd	concept_city_ketchikan
concept_radiostation_krcb	concept_city_rohnert_park
concept_radiostation_krcc	concept_city_colorado_springs
concept_radiostation_krcl	concept_county_salt_lake
concept_radiostation_krla	concept_county_los_angeles_county
concept_radiostation_krmg	concept_city_tulsa
concept_radiostation_kroq	concept_county_los_angeles_county
concept_radiostation_krty	concept_city_san_jose
concept_radiostation_krvm	concept_city_eugene
concept_radiostation_krvs	concept_city_lafayette
concept_radiostation_krza	concept_city_alamosa
concept_radiostation_ksan	concept_city_san_francisco
concept_radiostation_ksbj	concept_city_houston
concept_radiostation_ksds	concept_city_san_diego
concept_radiostation_kser	concept_city_everett
concept_radiostation_ksfo	concept_city_san_francisco
concept_radiostation_kska	concept_city_anchorage
concept_radiostation_kstk	concept_city_wrangell
concept_radiostation_ktao	concept_city_taos
concept_radiostation_ktar	concept_city_phoenix
concept_radiostation_ktep	concept_city_el_paso
concept_radiostation_ktna	concept_city_talkeetna
concept_radiostation_ktoo	concept_city_juneau
concept_radiostation_ktrh	concept_city_houston
concept_radiostation_ktwv	concept_county_los_angeles_county
concept_radiostation_kuaf	concept_city_fayetteville
concept_radiostation_kube_fm	concept_city_seattle
concept_radiostation_kuci	concept_city_irvine
concept_radiostation_kuhf	concept_city_houston
concept_radiostation_kumr	concept_city_rolla
concept_radiostation_kunc	concept_city_greeley
concept_radiostation_kunm	concept_city_albuquerque
concept_radiostation_kuop	concept_city_sacramento
concept_radiostation_kuow	concept_city_seattle
concept_radiostation_kuow_fm	concept_city_seattle
concept_radiostation_kusc	concept_county_los_angeles_county
concept_radiostation_kusp	concept_city_santa_cruz_das_flores
concept_radiostation_kut	concept_city_austin
concept_radiostation_kuvo	concept_city_denver
concept_radiostation_kvmr	concept_county_nevada_city
concept_radiostation_kvpr	concept_city_fresno
concept_radiostation_kwgs	concept_city_tulsa
concept_radiostation_kwit	concept_city_sioux_city
concept_radiostation_kxci	concept_city_tucson
concept_radiostation_kxcv	concept_city_maryville
concept_radiostation_kxjz	concept_city_sacramento
concept_radiostation_kxl	concept_city_portland
concept_radiostation_kxpr	concept_city_sacramento
concept_radiostation_kzaz	concept_city_bellingham
concept_radiostation_kzok_fm	concept_city_seattle
concept_radiostation_kzum	concept_city_lincoln
concept_radiostation_n106_9_the_point	concept_city_houston
concept_radiostation_n93_9_lite_fm	concept_city_chicago
concept_radiostation_wabc	concept_city_new_york
concept_radiostation_wabe	concept_city_atlanta
concept_radiostation_wamc	concept_city_albany
concept_radiostation_watd	concept_city_marshfield
concept_radiostation_wbai	concept_city_new_york
concept_radiostation_wbai_fm	concept_city_new_york
concept_radiostation_wbal	concept_city_baltimore
concept_radiostation_wben	concept_city_buffalo
concept_radiostation_wbez	concept_city_chicago
concept_radiostation_wbt	concept_city_charlotte
concept_radiostation_wbur	concept_city_boston
concept_radiostation_wcbs_tv	concept_city_new_york
concept_radiostation_wckg	concept_city_chicago
concept_radiostation_wclv	concept_city_cleveland
concept_radiostation_wcsx	concept_city_detroit
concept_radiostation_wdve	concept_city_pittsburgh
concept_radiostation_weei	concept_city_boston
concept_radiostation_wepr	concept_city_greenville
concept_radiostation_wevl	concept_city_memphis
concept_radiostation_wfan	concept_city_new_york
concept_radiostation_wfhb	concept_city_bloomington
concept_radiostation_wfiu	concept_city_bloomington
concept_radiostation_wfmt	concept_city_chicago
concept_radiostation_wfyi	concept_city_indianapolis
concept_radiostation_wgbh	concept_city_boston
concept_radiostation_wgn	concept_city_chicago
concept_radiostation_wgst	concept_city_atlanta
concept_radiostation_wguc	concept_city_cincinnati
concept_radiostation_whyy	concept_city_philadelphia
concept_radiostation_wibc	concept_city_indianapolis
concept_radiostation_wjff	concept_city_jeffersonville
concept_radiostation_wjhu	concept_city_baltimore
concept_radiostation_wjr	concept_city_detroit
concept_radiostation_wjz	concept_city_new_york
concept_radiostation_wkar	concept_city_east_lansing
concept_radiostation_wkbn_tv	concept_city_youngstown
concept_radiostation_wkdu	concept_city_philadelphia
concept_radiostation_wknh	concept_city_keene
concept_radiostation_wlw	concept_city_cincinnati
concept_radiostation_wmal	concept_city_washington_d_c
concept_radiostation_wmms	concept_city_cleveland
concept_radiostation_wmnf	concept_city_tampa_bay
concept_radiostation_wnec	concept_city_henniker
concept_radiostation_wnin	concept_city_evansville
concept_radiostation_wntr	concept_city_silver_springs
concept_radiostation_woai	concept_city_san_antonio
concept_radiostation_womr	concept_city_provincetown
concept_radiostation_wor	concept_city_new_york
concept_radiostation_word_fm	concept_city_pittsburgh
concept_radiostation_wort	concept_city_madison
concept_radiostation_wpht	concept_city_philadelphia
concept_radiostation_wpkn	concept_city_bridgeport
concept_radiostation_wqxr	concept_city_new_york
concept_radiostation_wrfg	concept_city_atlanta
concept_radiostation_wrif	concept_city_detroit
concept_radiostation_wrr	concept_city_dallas
concept_radiostation_wruw	concept_city_cleveland
concept_radiostation_wrva	concept_city_richmond
concept_radiostation_wscr	concept_city_chicago
concept_radiostation_wsm	concept_city_nashville
concept_radiostation_wtam	concept_city_cleveland
concept_radiostation_wtip	concept_island_grand_marais
concept_radiostation_wtmd	concept_county_towson
concept_radiostation_wtop	concept_city_washington_d_c
concept_radiostation_wumb	concept_city_boston
concept_radiostation_wusm	concept_city_hattiesburg
concept_radiostation_wvxu	concept_city_cincinnati
concept_radiostation_wwj	concept_city_detroit
concept_radiostation_wwoz	concept_city_new_orleans
concept_radiostation_wxrt	concept_city_chicago
concept_radiostation_wzzn	concept_city_chicago
concept_radiostation_xfm	concept_city_london_city
concept_recordlabel_warner_brothers	concept_city_burbank
concept_restaurant_burger_king	concept_city_miami
concept_televisionnetwork_abc	concept_city_new_york
concept_televisionnetwork_cbs	concept_city_new_york
concept_televisionstation_cbs58	concept_city_milwaukee
concept_televisionstation_kabb	concept_city_san_antonio
concept_televisionstation_kabc	concept_county_los_angeles_county
concept_televisionstation_kaef	concept_city_eureka
concept_televisionstation_kait	concept_city_jonesboro
concept_televisionstation_kake	concept_city_wichita
concept_televisionstation_kalb_dt	concept_city_alexandria
concept_televisionstation_kapp	concept_city_yakima
concept_televisionstation_kaqy_tv	concept_city_monroe
concept_televisionstation_kare	concept_city_minneapolis
concept_televisionstation_kare11	concept_city_minneapolis
concept_televisionstation_kark_tv	concept_city_little_rock
concept_televisionstation_kasn	concept_city_little_rock
concept_televisionstation_katu_tv	concept_city_portland
concept_televisionstation_katv	concept_city_little_rock
concept_televisionstation_kaza	concept_county_los_angeles_county
concept_televisionstation_kbak	concept_city_bakersfield
concept_televisionstation_kbcw	concept_city_san_francisco
concept_televisionstation_kbeh_tv	concept_county_los_angeles_county
concept_televisionstation_kbjr_tv	concept_city_duluth
concept_televisionstation_kbmt_tv	concept_city_beaumont
concept_televisionstation_kbnt	concept_city_san_diego
concept_televisionstation_kbnz	concept_city_bend
concept_televisionstation_kbsv	concept_city_modesto
concept_televisionstation_kbtv_tv	concept_city_sacramento
concept_televisionstation_kcal	concept_county_los_angeles_county
concept_televisionstation_kcba	concept_city_salinas
concept_televisionstation_kcbd	concept_city_lubbock
concept_televisionstation_kcbs	concept_county_los_angeles_county
concept_televisionstation_kcci	concept_city_des_moines
concept_televisionstation_kcet	concept_county_los_angeles_county
concept_televisionstation_kcnc_tv	concept_city_denver
concept_televisionstation_kcop_tv	concept_county_los_angeles_county
concept_televisionstation_kcpq	concept_city_seattle
concept_televisionstation_kcra	concept_city_sacramento
concept_televisionstation_kctv	concept_county_kansas_city
concept_televisionstation_kcvu	concept_city_chico
concept_televisionstation_kdfw	concept_city_dallas
concept_televisionstation_kdka	concept_city_pittsburgh
concept_televisionstation_kdoc	concept_city_lemoore
concept_televisionstation_kdtf	concept_city_san_diego
concept_televisionstation_kdtv	concept_city_san_francisco
concept_televisionstation_kdvr	concept_city_denver
concept_televisionstation_keci	concept_city_missoula
concept_televisionstation_keet	concept_city_eureka
concept_televisionstation_kens	concept_city_san_antonio
concept_televisionstation_kens_tv	concept_city_san_antonio
concept_televisionstation_kepr	concept_city_yakima
concept_televisionstation_kero	concept_city_bakersfield
concept_televisionstation_kesq	concept_city_palm_springs
concept_televisionstation_ketv_tv	concept_city_omaha
concept_televisionstation_keye	concept_city_austin
concept_televisionstation_keyt	concept_city_santa_barbara_de_nexe
concept_televisionstation_kezi_tv	concept_city_eugene
concept_televisionstation_kfbb	concept_city_great_falls
concept_televisionstation_kfmb	concept_city_san_diego
concept_televisionstation_kfor_tv	concept_city_oklahoma_city
concept_televisionstation_kfsn	concept_city_fresno
concept_televisionstation_kfty	concept_city_santa_rosa
concept_televisionstation_kgan	concept_city_cedar_rapids
concept_televisionstation_kgec	concept_city_redding
concept_televisionstation_kget	concept_city_bakersfield
concept_televisionstation_kgo	concept_city_san_francisco
concept_televisionstation_kgpe	concept_city_fresno
concept_televisionstation_kgtv_tv	concept_city_san_diego
concept_televisionstation_kgw__tv	concept_city_portland
concept_televisionstation_khiz	concept_county_los_angeles_county
concept_televisionstation_khou	concept_city_houston
concept_televisionstation_khsl	concept_city_chico
concept_televisionstation_kicu	concept_city_jose
concept_televisionstation_kiem	concept_city_eureka
concept_televisionstation_kiku	concept_city_honolulu
concept_televisionstation_king_tv	concept_city_bellevue
concept_televisionstation_kion	concept_city_salinas
concept_televisionstation_kiro	concept_city_seattle
concept_televisionstation_kitv	concept_city_honolulu
concept_televisionstation_kjla	concept_county_los_angeles_county
concept_televisionstation_kjzz	concept_county_salt_lake
concept_televisionstation_kktv	concept_city_colorado_springs
concept_televisionstation_klas	concept_city_las_vegas
concept_televisionstation_klas_tv	concept_city_las_vegas
concept_televisionstation_klax	concept_city_alexandria
concept_televisionstation_klbk	concept_city_lubbock
concept_televisionstation_klcs	concept_county_los_angeles_county
concept_televisionstation_klrn_tv	concept_city_san_antonio
concept_televisionstation_kmax	concept_city_sacramento
concept_televisionstation_kmbc	concept_county_kansas_city
concept_televisionstation_kmbz	concept_county_kansas_city
concept_televisionstation_kmex	concept_county_los_angeles_county
concept_televisionstation_kmgh	concept_city_denver
concept_televisionstation_kmov	concept_city_st__louis
concept_televisionstation_kmph_tv	concept_city_fresno
concept_televisionstation_kmtv	concept_city_omaha
concept_televisionstation_knbc	concept_county_los_angeles_county
concept_televisionstation_knsd	concept_city_san_diego
concept_televisionstation_kntv	concept_city_san_jose
concept_televisionstation_knvn_tv	concept_city_chico
concept_televisionstation_knxt_tv	concept_city_fresno
concept_televisionstation_knxv	concept_city_phoenix
concept_televisionstation_koaa	concept_city_colorado_springs
concept_televisionstation_koat	concept_city_albuquerque
concept_televisionstation_kob	concept_city_albuquerque
concept_televisionstation_kobi	concept_city_medford
concept_televisionstation_kocb	concept_city_oklahoma_city
concept_televisionstation_koce	concept_county_los_angeles_county
concept_televisionstation_koco	concept_city_oklahoma_city
concept_televisionstation_koin_tv	concept_city_portland
concept_televisionstation_kold_tv	concept_city_tucson
concept_televisionstation_komo	concept_city_seattle
concept_televisionstation_kong	concept_city_washington_d_c
concept_televisionstation_kovr	concept_city_sacramento
concept_televisionstation_kpbs	concept_city_san_diego
concept_televisionstation_kpdx	concept_city_portland
concept_televisionstation_kpho	concept_city_phoenix
concept_televisionstation_kpix	concept_city_san_francisco
concept_televisionstation_kplc_tv	concept_city_lake_charles
concept_televisionstation_kpnx	concept_city_phoenix
concept_televisionstation_kprc	concept_city_houston
concept_televisionstation_kpsp	concept_city_palm_springs
concept_televisionstation_kptv	concept_city_portland
concept_televisionstation_kpxn	concept_county_los_angeles_county
concept_televisionstation_kqed	concept_city_san_francisco
concept_televisionstation_kqed_tv	concept_city_san_francisco
concept_televisionstation_krca	concept_county_los_angeles_county
concept_televisionstation_krcb	concept_city_rohnert_park
concept_televisionstation_krcr_tv	concept_city_redding
concept_televisionstation_krem_tv	concept_city_spokane
concept_televisionstation_kris	concept_city_corpus_christi
concept_televisionstation_kriv	concept_city_houston
concept_televisionstation_kron	concept_city_san_francisco
concept_televisionstation_krrt	concept_city_san_antonio
concept_televisionstation_ksat	concept_city_san_antonio
concept_televisionstation_ksbw_tv	concept_city_monterey
concept_televisionstation_ksby_tv	concept_city_san_luis_obispo
concept_televisionstation_ksci	concept_county_los_angeles_county
concept_televisionstation_ksdk	concept_city_st__louis
concept_televisionstation_ksee	concept_city_fresno
concept_televisionstation_kshb	concept_county_kansas_city
concept_televisionstation_ksl	concept_county_salt_lake
concept_televisionstation_ksla_tv	concept_city_shreveport
concept_televisionstation_kswb	concept_city_diego
concept_televisionstation_ktbc	concept_city_austin
concept_televisionstation_ktbn	concept_city_santa_ana
concept_televisionstation_ktbs_tv	concept_city_shreveport
concept_televisionstation_kteh	concept_city_jose
concept_televisionstation_kthv	concept_city_little_rock
concept_televisionstation_ktnv_tv	concept_city_las_vegas
concept_televisionstation_ktrk	concept_city_houston
concept_televisionstation_ktsf_tv	concept_city_brisbane
concept_televisionstation_ktsm	concept_city_el_paso
concept_televisionstation_kttv	concept_county_los_angeles_county
concept_televisionstation_ktuu	concept_city_anchorage
concept_televisionstation_ktvb_tv	concept_city_twin_falls
concept_televisionstation_ktvd_tv	concept_city_denver
concept_televisionstation_ktvk	concept_city_phoenix
concept_televisionstation_ktvl_tv	concept_city_medford
concept_televisionstation_ktvt	concept_city_dallas
concept_televisionstation_ktvu	concept_city_oakland
concept_televisionstation_ktxl	concept_city_sacramento
concept_televisionstation_kusa	concept_city_denver
concept_televisionstation_kusi	concept_city_san_diego
concept_televisionstation_kutv	concept_county_salt_lake
concept_televisionstation_kuvs	concept_city_sacramento
concept_televisionstation_kval	concept_city_eugene
concept_televisionstation_kvbc	concept_city_las_vegas
concept_televisionstation_kvcr	concept_city_san_bernardino
concept_televisionstation_kvea	concept_county_los_angeles_county
concept_televisionstation_kvia	concept_city_el_paso
concept_televisionstation_kvie	concept_city_sacramento
concept_televisionstation_kviq	concept_city_eureka
concept_televisionstation_kvoa	concept_city_tucson
concept_televisionstation_kvos	concept_city_seattle
concept_televisionstation_kvpt	concept_city_fresno
concept_televisionstation_kvue_tv	concept_city_austin
concept_televisionstation_kvye	concept_city_el_centro
concept_televisionstation_kwch	concept_city_wichita
concept_televisionstation_kwhy	concept_city_glendale
concept_televisionstation_kxan	concept_city_austin
concept_televisionstation_kxas	concept_city_dallas
concept_televisionstation_kxla	concept_county_los_angeles_county
concept_televisionstation_kxly	concept_city_spokane
concept_televisionstation_kxtv	concept_city_sacramento
concept_televisionstation_kxxv	concept_city_waco
concept_televisionstation_kzdf	concept_city_san_diego
concept_televisionstation_macon	concept_city_lafayette
concept_televisionstation_n9news	concept_city_denver
concept_televisionstation_nbc10	concept_city_philadelphia
concept_televisionstation_nbc15	concept_city_madison
concept_televisionstation_nbc5	concept_city_chicago
concept_televisionstation_newschannel5	concept_city_nashville
concept_televisionstation_newsnet5	concept_city_cleveland
concept_televisionstation_sunherald	concept_city_biloxi
concept_televisionstation_thedenverchannel	concept_city_denver
concept_televisionstation_theindychannel	concept_city_indianapolis
concept_televisionstation_waff	concept_city_huntsville
concept_televisionstation_waga	concept_city_atlanta
concept_televisionstation_wave	concept_city_louisville
concept_televisionstation_wbaltv	concept_city_baltimore
concept_televisionstation_wbap	concept_city_ft__worth
concept_televisionstation_wbff_tv	concept_city_baltimore
concept_televisionstation_wbir_tv	concept_city_knoxville
concept_televisionstation_wbns_tv	concept_city_columbus
concept_televisionstation_wboc	concept_city_salisbury
concept_televisionstation_wbz__tv	concept_city_boston
concept_televisionstation_wcax	concept_city_burlington
concept_televisionstation_wcft	concept_city_birmingham
concept_televisionstation_wciv_tv	concept_city_charleston
concept_televisionstation_wcmh	concept_city_columbus
concept_televisionstation_wcti	concept_city_new_bern
concept_televisionstation_wcvb	concept_city_boston
concept_televisionstation_wday	concept_city_fargo
concept_televisionstation_wdiv	concept_city_detroit
concept_televisionstation_wdsu	concept_city_new_orleans
concept_televisionstation_wear	concept_city_pensacola
concept_televisionstation_wesh	concept_city_orlando
concept_televisionstation_wews_tv	concept_city_cleveland
concept_televisionstation_wfla	concept_city_tampa_bay
concept_televisionstation_wfld	concept_city_chicago
concept_televisionstation_wfld_tv	concept_city_chicago
concept_televisionstation_wfmy	concept_city_greensboro
concept_televisionstation_wftv	concept_city_orlando
concept_televisionstation_wgal_tv	concept_city_lancaster
concept_televisionstation_wgbh	concept_city_boston
concept_televisionstation_wgn_tv	concept_city_chicago
concept_televisionstation_wgrz_tv	concept_city_buffalo
concept_televisionstation_wgy	concept_city_schenectady
concept_televisionstation_whdh	concept_city_boston
concept_televisionstation_wics_tv	concept_city_springfield
concept_televisionstation_wish_tv	concept_city_indianapolis
concept_televisionstation_wisn	concept_city_milwaukee
concept_televisionstation_wjw	concept_city_cleveland
concept_televisionstation_wjz_tv	concept_city_baltimore
concept_televisionstation_wkrn	concept_city_nashville
concept_televisionstation_wkyc_tv	concept_city_cleveland
concept_televisionstation_wlac	concept_city_nashville
concept_televisionstation_wlbz2	concept_city_bangor
concept_televisionstation_wlex_tv	concept_county_lexington
concept_televisionstation_wlky_tv	concept_city_louisville
concept_televisionstation_wls	concept_city_chicago
concept_televisionstation_wlw	concept_city_cincinnati
concept_televisionstation_wlwt	concept_city_cincinnati
concept_televisionstation_wmaz_tv	concept_city_macon
concept_televisionstation_wmc_tv	concept_city_memphis
concept_televisionstation_wnbc_tv	concept_city_new_york
concept_televisionstation_wnet	concept_city_new_york
concept_televisionstation_wnky_dt	concept_geopoliticallocation_bowling_green
concept_televisionstation_woio_tv	concept_city_cleveland
concept_televisionstation_wplg	concept_city_miami
concept_televisionstation_wptz	concept_city_burlington
concept_televisionstation_wpvi_tv	concept_city_philadelphia
concept_televisionstation_wpxi_tv	concept_city_pittsburgh
concept_televisionstation_wqad	concept_city_davenport
concept_televisionstation_wsbtv	concept_city_atlanta
concept_televisionstation_wsls	concept_city_roanoke
concept_televisionstation_wsmv	concept_city_nashville
concept_televisionstation_wtae	concept_city_pittsburgh
concept_televisionstation_wtev	concept_city_jacksonville
concept_televisionstation_wthr	concept_city_indianapolis
concept_televisionstation_wtnh	concept_city_new_haven
concept_televisionstation_wtoc_tv	concept_city_savannah
concept_televisionstation_wtol	concept_city_toledo
concept_televisionstation_wtvf_tv	concept_city_nashville
concept_televisionstation_wtvr	concept_city_richmond
concept_televisionstation_wtvr_tv	concept_city_richmond
concept_televisionstation_wtvt_tv	concept_city_tampa_bay
concept_televisionstation_wvit	concept_city_hartford
concept_televisionstation_wway_tv	concept_city_wilmington
concept_televisionstation_wwbt	concept_city_richmond
concept_televisionstation_wwl	concept_city_new_orleans
concept_televisionstation_wwltv	concept_city_new_orleans
concept_televisionstation_wwor	concept_city_new_york
concept_televisionstation_wxia	concept_city_atlanta
concept_televisionstation_wxix	concept_city_cincinnati
concept_televisionstation_wxyz	concept_city_detroit
concept_televisionstation_wzzm	concept_city_grand_rapids_kalamazoo_battle_creek
concept_televisionstation_xetv	concept_city_san_diego
concept_website_abc_world_news	concept_city_new_york
concept_website_amazon	concept_city_seattle
concept_website_associated_press	concept_city_new_york
concept_website_bloomberg_news	concept_city_new_york
concept_website_cbs_evening_news	concept_city_new_york
concept_website_daily_news	concept_city_new_york
concept_website_entertainment_weekly	concept_city_new_york
concept_website_espn_the_magazine	concept_city_new_york
concept_website_facebook	concept_city_palo_alto
concept_website_fortune	concept_city_new_york
concept_website_fox_news	concept_city_new_york
concept_website_good_housekeeping	concept_city_new_york
concept_website_herald_tribune	concept_city_washington_d_c
concept_website_marketwatch	concept_city_new_york
concept_website_mother_jones_magazine	concept_city_new_york
concept_website_new_york_american	concept_city_new_york
concept_website_new_york_daily	concept_city_new_york
concept_website_new_york_review_of_books	concept_city_new_york
concept_website_new_york_times	concept_city_new_york
concept_website_new_york_times_a	concept_city_new_york
concept_website_new_york_times_book_review	concept_city_new_york
concept_website_new_york_tribune	concept_city_new_york
concept_website_new_yorker_magazine	concept_city_new_york
concept_website_newsweek	concept_city_new_york
concept_website_nyt_	concept_city_new_york
concept_website_people_magazine	concept_city_new_york
concept_website_publishers_weekly	concept_city_new_york
concept_website_the_daily_news	concept_city_new_york
concept_website_the_nation	concept_city_new_york
concept_website_time_magazine	concept_city_new_york
concept_website_times_magazine	concept_city_new_york
concept_website_times_newspapers	concept_city_washington_d_c
concept_website_village_voice	concept_city_new_york
concept_website_washington_post	concept_city_washington_d_c
concept_website_washington_star	concept_city_washington_d_c
concept_website_washington_times	concept_city_washington_d_c
