concept_bank_iowa_state	concept_sportsleague_ncaa
concept_blog_harvard_crimson	concept_sportsleague_ncaa
concept_city_arkansas	concept_sportsleague_ncaa
concept_city_army	concept_sportsleague_ncaa
concept_city_evansville_aces	concept_sportsleague_ncaa
concept_city_florida	concept_sportsleague_ncaa
concept_city_georgetown	concept_sportsleague_ncaa
concept_city_gonzaga	concept_sportsleague_ncaa
concept_city_louisville	concept_sportsleague_ncaa
concept_city_pittsburgh	concept_sportsleague_ncaa
concept_city_texas	concept_sportsleague_ncaa
concept_city_washington_d_c	concept_sportsleague_ncaa
concept_city_xavier	concept_sportsleague_ncaa
concept_company_arizona	concept_sportsleague_ncaa
concept_company_tiger	concept_sportsleague_ncaa
concept_company_west_virginia	concept_sportsleague_ncaa
concept_county_business_school	concept_sportsleague_ncaa
concept_county_penn_state	concept_sportsleague_ncaa
concept_county_slippery_rock_university	concept_sportsleague_ncaa
concept_creditunion_kansas	concept_sportsleague_ncaa
concept_creditunion_michigan	concept_sportsleague_ncaa
concept_creditunion_north_carolina	concept_sportsleague_ncaa
concept_creditunion_wisconsin	concept_sportsleague_ncaa
concept_geopoliticallocation_agencies	concept_sportsleague_ncaa
concept_geopoliticallocation_south_florida	concept_sportsleague_ncaa
concept_governmentorganization_department_of_commerce	concept_sportsleague_ncaa
concept_governmentorganization_patriot	concept_sportsleague_nfl
concept_governmentorganization_regulations	concept_sportsleague_ncaa
concept_governmentorganization_supreme_court	concept_sportsleague_ncaa
concept_organization_civil_affairs_and_psychological_operations_command	concept_sportsleague_ncaa
concept_organization_george_bush_school_of_government_and_public_service	concept_sportsleague_ncaa
concept_radiostation_cincinnati	concept_sportsleague_ncaa
concept_radiostation_nevada	concept_sportsleague_ncaa
concept_school_duke	concept_sportsleague_ncaa
concept_school_junipero_serra_high_school	concept_sportsleague_nfl
concept_sportsleague_southeastern_conference	concept_sportsleague_ncaa
concept_sportsleague_syracuse	concept_sportsleague_ncaa
concept_sportsteam_abilene_christian_university_wildcats	concept_sportsleague_ncaa
concept_sportsteam_acc_gear	concept_sportsleague_ncaa
concept_sportsteam_adelphi_university_panthers	concept_sportsleague_ncaa
concept_sportsteam_air_force_falcons	concept_sportsleague_ncaa
concept_sportsteam_akron_zips	concept_sportsleague_ncaa
concept_sportsteam_alabama_a_and_m_bulldogs	concept_sportsleague_ncaa
concept_sportsteam_alabama_a_m_bulldogs	concept_sportsleague_ncaa
concept_sportsteam_alabama_birmingham_blazers	concept_sportsleague_ncaa
concept_sportsteam_alabama_crimson_tide	concept_sportsleague_ncaa
concept_sportsteam_alabama_huntsville_chargers	concept_sportsleague_ncaa
concept_sportsteam_alabama_huntsville_uah_chargers	concept_sportsleague_ncaa
concept_sportsteam_alabama_state_hornets	concept_sportsleague_ncaa
concept_sportsteam_alaska_anchorage_seawolves	concept_sportsleague_ncaa
concept_sportsteam_alaska_fairbanks_nanooks	concept_sportsleague_ncaa
concept_sportsteam_alaska_seawolves	concept_sportsleague_ncaa
concept_sportsteam_albany_great_danes	concept_sportsleague_ncaa
concept_sportsteam_albany_state_golden_rams	concept_sportsleague_ncaa
concept_sportsteam_alcorn_state_braves	concept_sportsleague_ncaa
concept_sportsteam_american_eagles	concept_sportsleague_ncaa
concept_sportsteam_american_university	concept_sportsleague_ncaa
concept_sportsteam_anderson_ravens	concept_sportsleague_ncaa
concept_sportsteam_angelo_state_rams	concept_sportsleague_ncaa
concept_sportsteam_angelo_state_university_rams	concept_sportsleague_ncaa
concept_sportsteam_appalachian_state_mo	concept_sportsleague_ncaa
concept_sportsteam_arizona_cardinals_27_23	concept_sportsleague_nfl
concept_sportsteam_arizona_diamond_backs	concept_sportsleague_mlb
concept_sportsteam_arizona_state_sun_devils	concept_sportsleague_ncaa
concept_sportsteam_arizona_wildcats	concept_sportsleague_ncaa
concept_sportsteam_arkansas_fort_smith_lions	concept_sportsleague_ncaa
concept_sportsteam_arkansas_pine_bluff_golden_lions	concept_sportsleague_ncaa
concept_sportsteam_arkansas_razorbacks	concept_sportsleague_ncaa
concept_sportsteam_arkansas_state_red_wolves	concept_sportsleague_ncaa
concept_sportsteam_arkansas_tech_wonder_boys	concept_sportsleague_ncaa
concept_sportsteam_armstrong_atlantic_pirates	concept_sportsleague_ncaa
concept_sportsteam_army_black_knights	concept_sportsleague_ncaa
concept_sportsteam_ashland_eagles	concept_sportsleague_ncaa
concept_sportsteam_atlanta_braves	concept_sportsleague_mlb
concept_sportsteam_atlanta_thrashers	concept_sportsleague_nba
concept_sportsteam_atlantic_10_gear	concept_sportsleague_ncaa
concept_sportsteam_auburn_montgomery_senators	concept_sportsleague_ncaa
concept_sportsteam_auburn_tigers	concept_sportsleague_ncaa
concept_sportsteam_augustana_vikings	concept_sportsleague_ncaa
concept_sportsteam_austin_peay_governors	concept_sportsleague_ncaa
concept_sportsteam_austin_peay_state_governors	concept_sportsleague_ncaa
concept_sportsteam_ave_maria_gyrenes	concept_sportsleague_ncaa
concept_sportsteam_baker_wildcats	concept_sportsleague_ncaa
concept_sportsteam_ball_state_cardinals	concept_sportsleague_ncaa
concept_sportsteam_barry_university	concept_sportsleague_ncaa
concept_sportsteam_baruch_college_bearcats	concept_sportsleague_ncaa
concept_sportsteam_baylor_bears	concept_sportsleague_ncaa
concept_sportsteam_bears_29_17	concept_sportsleague_nfl
concept_sportsteam_bellarmine_knights	concept_sportsleague_ncaa
concept_sportsteam_bellevue_college_bulldogs	concept_sportsleague_ncaa
concept_sportsteam_belmont_bruins	concept_sportsleague_ncaa
concept_sportsteam_bemidji_state_beavers	concept_sportsleague_ncaa
concept_sportsteam_bengals	concept_sportsleague_mlb
concept_sportsteam_bengals	concept_sportsleague_nfl
concept_sportsteam_bethune_cookman_university_wildcats	concept_sportsleague_ncaa
concept_sportsteam_bethune_cookman_wildcats	concept_sportsleague_ncaa
concept_sportsteam_big_12_gear	concept_sportsleague_ncaa
concept_sportsteam_big_east_gear	concept_sportsleague_ncaa
concept_sportsteam_big_sky_conference_gear	concept_sportsleague_ncaa
concept_sportsteam_big_ten_gear	concept_sportsleague_ncaa
concept_sportsteam_binghamton_bearcats	concept_sportsleague_ncaa
concept_sportsteam_binghamton_university	concept_sportsleague_ncaa
concept_sportsteam_birmingham_southern_college_panthers	concept_sportsleague_ncaa
concept_sportsteam_blackhawks	concept_sportsleague_mlb
concept_sportsteam_bloomsburg_huskies	concept_sportsleague_ncaa
concept_sportsteam_blue_jays	concept_sportsleague_cfl
concept_sportsteam_blue_jays	concept_sportsleague_mlb
concept_sportsteam_boise_state_broncos	concept_sportsleague_ncaa
concept_sportsteam_boston_bruins	concept_sportsleague_nba
concept_sportsteam_boston_celtics	concept_sportsleague_nba
concept_sportsteam_boston_college	concept_sportsleague_ncaa
concept_sportsteam_boston_terriers	concept_sportsleague_ncaa
concept_sportsteam_boston_university_terriers	concept_sportsleague_ncaa
concept_sportsteam_bowdoin	concept_sportsleague_ncaa
concept_sportsteam_bowling_green_falcons	concept_sportsleague_ncaa
concept_sportsteam_bowling_green_st__falcons	concept_sportsleague_ncaa
concept_sportsteam_bradley_braves	concept_sportsleague_ncaa
concept_sportsteam_bridgewater_state_bears	concept_sportsleague_ncaa
concept_sportsteam_brigham_young_cougars	concept_sportsleague_ncaa
concept_sportsteam_brockport_golden_eagles	concept_sportsleague_ncaa
concept_sportsteam_broncos	concept_sportsleague_nfl
concept_sportsteam_brooklyn_college_bulldogs	concept_sportsleague_ncaa
concept_sportsteam_brown_bears	concept_sportsleague_ncaa
concept_sportsteam_bryant_bulldogs	concept_sportsleague_ncaa
concept_sportsteam_buccaneers	concept_sportsleague_nfl
concept_sportsteam_bucknell_bison	concept_sportsleague_ncaa
concept_sportsteam_buffalo_bills	concept_sportsleague_nfl
concept_sportsteam_buffalo_bulls	concept_sportsleague_ncaa
concept_sportsteam_buffalo_state	concept_sportsleague_ncaa
concept_sportsteam_butler_bulldogs	concept_sportsleague_ncaa
concept_sportsteam_byu	concept_sportsleague_ncaa
concept_sportsteam_byu_cougars	concept_sportsleague_ncaa
concept_sportsteam_byu_idaho_vikings	concept_sportsleague_ncaa
concept_sportsteam_cal_bears	concept_sportsleague_ncaa
concept_sportsteam_cal_golden_bears	concept_sportsleague_ncaa
concept_sportsteam_cal_poly_mustangs	concept_sportsleague_ncaa
concept_sportsteam_cal_state_bakersfield_roadrunners	concept_sportsleague_ncaa
concept_sportsteam_cal_state_channel_island_dolphins	concept_sportsleague_ncaa
concept_sportsteam_cal_state_chico_wildcats	concept_sportsleague_ncaa
concept_sportsteam_cal_state_dominguez_hills_toros	concept_sportsleague_ncaa
concept_sportsteam_cal_state_east_bay_pioneers	concept_sportsleague_ncaa
concept_sportsteam_cal_state_fullerton_titans	concept_sportsleague_ncaa
concept_sportsteam_cal_state_los_angeles_golden_eagles	concept_sportsleague_ncaa
concept_sportsteam_cal_state_monterey_bay_otters	concept_sportsleague_ncaa
concept_sportsteam_cal_state_northridge_matadors	concept_sportsleague_ncaa
concept_sportsteam_cal_state_san_bernardino_coyotes	concept_sportsleague_ncaa
concept_sportsteam_cal_state_san_marcos_cougars	concept_sportsleague_ncaa
concept_sportsteam_cal_state_stanislaus_warriors	concept_sportsleague_ncaa
concept_sportsteam_caldwell_cougars	concept_sportsleague_ncaa
concept_sportsteam_california_golden_bears	concept_sportsleague_ncaa
concept_sportsteam_california_university_of_pennsylvania_vulcans	concept_sportsleague_ncaa
concept_sportsteam_cameron_aggies	concept_sportsleague_ncaa
concept_sportsteam_campbell_fighting_camels	concept_sportsleague_ncaa
concept_sportsteam_canisius_college_golden_griffins	concept_sportsleague_ncaa
concept_sportsteam_canisius_golden_griffins	concept_sportsleague_ncaa
concept_sportsteam_capitals	concept_sportsleague_nba
concept_sportsteam_capitals	concept_sportsleague_nhl
concept_sportsteam_carnegie_mellon_tartans	concept_sportsleague_ncaa
concept_sportsteam_carroll_college_fighting_saints	concept_sportsleague_ncaa
concept_sportsteam_cavaliers	concept_sportsleague_nba
concept_sportsteam_cent__michigan_chippewas	concept_sportsleague_ncaa
concept_sportsteam_centenary_college	concept_sportsleague_ncaa
concept_sportsteam_central_arkansas_bears	concept_sportsleague_ncaa
concept_sportsteam_central_connecticut_state_blue_devils	concept_sportsleague_ncaa
concept_sportsteam_central_florida_golden_knights	concept_sportsleague_ncaa
concept_sportsteam_central_florida_knights	concept_sportsleague_ncaa
concept_sportsteam_central_michigan_chippewas	concept_sportsleague_ncaa
concept_sportsteam_central_missouri_mules	concept_sportsleague_ncaa
concept_sportsteam_central_oklahoma_bronchos	concept_sportsleague_ncaa
concept_sportsteam_central_oklahoma_broncos	concept_sportsleague_ncaa
concept_sportsteam_central_state_marauders	concept_sportsleague_ncaa
concept_sportsteam_central_washington_wildcats	concept_sportsleague_ncaa
concept_sportsteam_chapman_panthers	concept_sportsleague_ncaa
concept_sportsteam_charleston_cougars	concept_sportsleague_ncaa
concept_sportsteam_charleston_southern_buccaneers	concept_sportsleague_ncaa
concept_sportsteam_charlotte_49ers	concept_sportsleague_ncaa
concept_sportsteam_charlotte_bobcats	concept_sportsleague_nba
concept_sportsteam_chicago_bulls	concept_sportsleague_nba
concept_sportsteam_chicago_bulls	concept_sportsleague_nhl
concept_sportsteam_chicago_cubs	concept_sportsleague_mlb
concept_sportsteam_chicago_maroons	concept_sportsleague_ncaa
concept_sportsteam_chicago_state_cougars	concept_sportsleague_ncaa
concept_sportsteam_chicago_white_sox	concept_sportsleague_mlb
concept_sportsteam_chowan_braves	concept_sportsleague_mlb
concept_sportsteam_christian_brothers_buccaneers	concept_sportsleague_ncaa
concept_sportsteam_christopher_newport_captains	concept_sportsleague_ncaa
concept_sportsteam_cincinnati_bearcats	concept_sportsleague_ncaa
concept_sportsteam_citadel_bulldogs	concept_sportsleague_ncaa
concept_sportsteam_city_tech_yellow_jackets	concept_sportsleague_ncaa
concept_sportsteam_clarion_golden_eagles	concept_sportsleague_ncaa
concept_sportsteam_clark_atlanta_panthers	concept_sportsleague_ncaa
concept_sportsteam_clark_university	concept_sportsleague_ncaa
concept_sportsteam_clarke_college_crusaders	concept_sportsleague_ncaa
concept_sportsteam_clarkson_golden_knights	concept_sportsleague_ncaa
concept_sportsteam_clemson_tigers	concept_sportsleague_ncaa
concept_sportsteam_cleveland_browns	concept_sportsleague_nfl
concept_sportsteam_cleveland_indians	concept_sportsleague_mlb
concept_sportsteam_cleveland_state_vikings	concept_sportsleague_ncaa
concept_sportsteam_coast_guard_academy_bears	concept_sportsleague_ncaa
concept_sportsteam_coastal_carolina_chanticleers	concept_sportsleague_ncaa
concept_sportsteam_colgate_raiders	concept_sportsleague_ncaa
concept_sportsteam_college_of_charleston	concept_sportsleague_ncaa
concept_sportsteam_college_of_new_jersey_lions	concept_sportsleague_ncaa
concept_sportsteam_college_of_staten_island_dolphins	concept_sportsleague_ncaa
concept_sportsteam_colorado_avalanche	concept_sportsleague_nba
concept_sportsteam_colorado_buffaloes	concept_sportsleague_ncaa
concept_sportsteam_colorado_rockies	concept_sportsleague_mlb
concept_sportsteam_colorado_school_of_mines_orediggers	concept_sportsleague_ncaa
concept_sportsteam_colorado_state	concept_sportsleague_ncaa
concept_sportsteam_colorado_state_rams	concept_sportsleague_ncaa
concept_sportsteam_colts	concept_sportsleague_nfl
concept_sportsteam_columbia_lions	concept_sportsleague_ncaa
concept_sportsteam_columbia_university_lions	concept_sportsleague_ncaa
concept_sportsteam_columbus_state_cougars	concept_sportsleague_ncaa
concept_sportsteam_concordia_irvine_eagles	concept_sportsleague_ncaa
concept_sportsteam_concordia_texas_tornadoes	concept_sportsleague_ncaa
concept_sportsteam_concordia_university_wisconsin_falcons	concept_sportsleague_ncaa
concept_sportsteam_conference_usa_gear	concept_sportsleague_ncaa
concept_sportsteam_connecticut_huskies	concept_sportsleague_ncaa
concept_sportsteam_coppin_state_eagles	concept_sportsleague_ncaa
concept_sportsteam_cornell_big_red	concept_sportsleague_ncaa
concept_sportsteam_creighton_blue_jays	concept_sportsleague_ncaa
concept_sportsteam_creighton_bluejays	concept_sportsleague_ncaa
concept_sportsteam_cumberland_bulldogs	concept_sportsleague_ncaa
concept_sportsteam_dakota_state_trojans	concept_sportsleague_ncaa
concept_sportsteam_dallas_baptist_patriots	concept_sportsleague_ncaa
concept_sportsteam_dallas_cowboys	concept_sportsleague_nfl
concept_sportsteam_dallas_mavericks	concept_sportsleague_nba
concept_sportsteam_dartmouth_big_green	concept_sportsleague_ncaa
concept_sportsteam_davenport_panthers	concept_sportsleague_ncaa
concept_sportsteam_davidson_college_wildcats	concept_sportsleague_ncaa
concept_sportsteam_davidson_wildcats	concept_sportsleague_ncaa
concept_sportsteam_dayton_flyers	concept_sportsleague_ncaa
concept_sportsteam_delaware_blue_hens	concept_sportsleague_ncaa
concept_sportsteam_delaware_fightin__blue_hens	concept_sportsleague_ncaa
concept_sportsteam_delaware_fightin_blue_hens	concept_sportsleague_ncaa
concept_sportsteam_delaware_state_hornets	concept_sportsleague_ncaa
concept_sportsteam_delta_state_fighting_okra	concept_sportsleague_ncaa
concept_sportsteam_denver_nuggets	concept_sportsleague_nba
concept_sportsteam_denver_pioneers	concept_sportsleague_ncaa
concept_sportsteam_depaul_blue_demons	concept_sportsleague_ncaa
concept_sportsteam_depauw_tigers	concept_sportsleague_ncaa
concept_sportsteam_detroit_mercy_titans	concept_sportsleague_ncaa
concept_sportsteam_detroit_tigers	concept_sportsleague_mlb
concept_sportsteam_detroit_titans	concept_sportsleague_ncaa
concept_sportsteam_district_of_columbia_firebirds	concept_sportsleague_ncaa
concept_sportsteam_dixie_state_red_storm	concept_sportsleague_ncaa
concept_sportsteam_dodgers	concept_sportsleague_mlb
concept_sportsteam_dominican_stars	concept_sportsleague_ncaa
concept_sportsteam_dowling_college_golden_lions	concept_sportsleague_ncaa
concept_sportsteam_drake_bulldogs	concept_sportsleague_ncaa
concept_sportsteam_drake_university_bulldogs	concept_sportsleague_ncaa
concept_sportsteam_drexel_dragons	concept_sportsleague_ncaa
concept_sportsteam_duke_blue_devils	concept_sportsleague_ncaa
concept_sportsteam_duquesne_dukes	concept_sportsleague_ncaa
concept_sportsteam_east_carolina_pirates	concept_sportsleague_ncaa
concept_sportsteam_east_stroudsburg_warriors	concept_sportsleague_ncaa
concept_sportsteam_east_tennessee_state_buccaneers	concept_sportsleague_ncaa
concept_sportsteam_east_tennessee_state_lady_buccaneers	concept_sportsleague_ncaa
concept_sportsteam_eastern_illinois_panthers	concept_sportsleague_ncaa
concept_sportsteam_eastern_kentucky_colonels	concept_sportsleague_ncaa
concept_sportsteam_eastern_michigan_eagles	concept_sportsleague_ncaa
concept_sportsteam_eastern_university	concept_sportsleague_ncaa
concept_sportsteam_eastern_washington_eagles	concept_sportsleague_ncaa
concept_sportsteam_eastern_wyoming_college_lancers	concept_sportsleague_ncaa
concept_sportsteam_ecsu_vikings	concept_sportsleague_ncaa
concept_sportsteam_edward_waters_tigers	concept_sportsleague_ncaa
concept_sportsteam_elmhurst_college	concept_sportsleague_ncaa
concept_sportsteam_elmira_college_soaring_eagles	concept_sportsleague_ncaa
concept_sportsteam_elon_phoenix	concept_sportsleague_ncaa
concept_sportsteam_embry_riddle_eagles	concept_sportsleague_ncaa
concept_sportsteam_emory_eagles	concept_sportsleague_ncaa
concept_sportsteam_emporia_state_hornets	concept_sportsleague_ncaa
concept_sportsteam_evansville_purple_aces	concept_sportsleague_ncaa
concept_sportsteam_fairfield_stags	concept_sportsleague_ncaa
concept_sportsteam_fairfield_university_stags	concept_sportsleague_ncaa
concept_sportsteam_fairleigh_dickinson_knights	concept_sportsleague_ncaa
concept_sportsteam_fairmont_state_falcons	concept_sportsleague_ncaa
concept_sportsteam_falcons	concept_sportsleague_nfl
concept_sportsteam_faulkner_eagles	concept_sportsleague_ncaa
concept_sportsteam_faulkner_state_sun_chiefs	concept_sportsleague_ncaa
concept_sportsteam_fayetteville_state_broncos	concept_sportsleague_ncaa
concept_sportsteam_ferris_state_bulldogs	concept_sportsleague_ncaa
concept_sportsteam_fiesta_bowl_gear	concept_sportsleague_ncaa
concept_sportsteam_fighting_illini	concept_sportsleague_ncaa
concept_sportsteam_flagler_college_saints	concept_sportsleague_ncaa
concept_sportsteam_florida_a_and_m_rattlers	concept_sportsleague_ncaa
concept_sportsteam_florida_a_m_rattlers	concept_sportsleague_ncaa
concept_sportsteam_florida_atlantic_owls	concept_sportsleague_ncaa
concept_sportsteam_florida_atlantic_university_owls	concept_sportsleague_ncaa
concept_sportsteam_florida_gators	concept_sportsleague_ncaa
concept_sportsteam_florida_gulf_coast_eagles	concept_sportsleague_ncaa
concept_sportsteam_florida_international_golden_panthers	concept_sportsleague_ncaa
concept_sportsteam_florida_marlins	concept_sportsleague_nfl
concept_sportsteam_florida_southern_college	concept_sportsleague_ncaa
concept_sportsteam_florida_state_seminoles	concept_sportsleague_ncaa
concept_sportsteam_flyers_playoff_tickets	concept_sportsleague_nfl
concept_sportsteam_fordham_rams	concept_sportsleague_ncaa
concept_sportsteam_fordham_university	concept_sportsleague_ncaa
concept_sportsteam_former_san_francisco_giants	concept_sportsleague_nfl
concept_sportsteam_fort_hays_state_tigers	concept_sportsleague_ncaa
concept_sportsteam_fort_lewis_college_skyhawks	concept_sportsleague_ncaa
concept_sportsteam_fort_valley_state_wildcats	concept_sportsleague_ncaa
concept_sportsteam_franklin_and_marshall_diplomats	concept_sportsleague_ncaa
concept_sportsteam_fredonia_state_blue_devils	concept_sportsleague_ncaa
concept_sportsteam_fresno_city_college_rams	concept_sportsleague_ncaa
concept_sportsteam_fresno_state_bulldogs	concept_sportsleague_ncaa
concept_sportsteam_furman_paladins	concept_sportsleague_ncaa
concept_sportsteam_ga_tech_yellow_jackets	concept_sportsleague_ncaa
concept_sportsteam_gardner_webb_bulldogs	concept_sportsleague_ncaa
concept_sportsteam_george_mason_patriots	concept_sportsleague_ncaa
concept_sportsteam_george_washington_colonials	concept_sportsleague_ncaa
concept_sportsteam_georgetown_college	concept_sportsleague_ncaa
concept_sportsteam_georgetown_hoyas	concept_sportsleague_ncaa
concept_sportsteam_georgia_bulldogs	concept_sportsleague_ncaa
concept_sportsteam_georgia_southern_eagles	concept_sportsleague_ncaa
concept_sportsteam_georgia_southwestern_hurricanes	concept_sportsleague_ncaa
concept_sportsteam_georgia_state	concept_sportsleague_ncaa
concept_sportsteam_georgia_tech	concept_sportsleague_ncaa
concept_sportsteam_golden_state_warriors	concept_sportsleague_nba
concept_sportsteam_gonzaga_bulldogs	concept_sportsleague_ncaa
concept_sportsteam_governors_state_university	concept_sportsleague_ncaa
concept_sportsteam_grace_lancers	concept_sportsleague_ncaa
concept_sportsteam_graceland_yellowjackets	concept_sportsleague_ncaa
concept_sportsteam_grambling_tigers	concept_sportsleague_ncaa
concept_sportsteam_grand_canyon_antelopes	concept_sportsleague_ncaa
concept_sportsteam_grand_valley_state_lakers	concept_sportsleague_ncaa
concept_sportsteam_great_lakes_valley_conference_gear	concept_sportsleague_ncaa
concept_sportsteam_greensboro	concept_sportsleague_ncaa
concept_sportsteam_gw_colonials	concept_sportsleague_ncaa
concept_sportsteam_hamline_pipers	concept_sportsleague_ncaa
concept_sportsteam_hampden_sydney_college_tigers	concept_sportsleague_ncaa
concept_sportsteam_hampton_pirates	concept_sportsleague_ncaa
concept_sportsteam_hardin_simmons_university_cowboys	concept_sportsleague_ncaa
concept_sportsteam_harper_college_hawks	concept_sportsleague_ncaa
concept_sportsteam_hartford_hawks	concept_sportsleague_ncaa
concept_sportsteam_hawaii_warriors	concept_sportsleague_ncaa
concept_sportsteam_hawks	concept_sportsleague_nba
concept_sportsteam_heat	concept_sportsleague_nba
concept_sportsteam_henderson_state_university_reddies	concept_sportsleague_ncaa
concept_sportsteam_high_point_panthers	concept_sportsleague_ncaa
concept_sportsteam_high_point_university_panthers	concept_sportsleague_ncaa
concept_sportsteam_hofstra_pride	concept_sportsleague_ncaa
concept_sportsteam_hofstra_university	concept_sportsleague_ncaa
concept_sportsteam_holy_cross_crusaders	concept_sportsleague_ncaa
concept_sportsteam_houston_astros	concept_sportsleague_mlb
concept_sportsteam_houston_baptist_huskies	concept_sportsleague_ncaa
concept_sportsteam_houston_cougars	concept_sportsleague_ncaa
concept_sportsteam_howard_bison	concept_sportsleague_ncaa
concept_sportsteam_humboldt_state_jacks	concept_sportsleague_ncaa
concept_sportsteam_hunter_college	concept_sportsleague_ncaa
concept_sportsteam_huntington_foresters	concept_sportsleague_ncaa
concept_sportsteam_huston_tillotson_university_rams	concept_sportsleague_ncaa
concept_sportsteam_idaho_state_bengals	concept_sportsleague_ncaa
concept_sportsteam_idaho_vandals	concept_sportsleague_ncaa
concept_sportsteam_illinois_chicago_flames	concept_sportsleague_ncaa
concept_sportsteam_illinois_fighting_illini	concept_sportsleague_ncaa
concept_sportsteam_illinois_state	concept_sportsleague_ncaa
concept_sportsteam_indiana_hoosiers	concept_sportsleague_ncaa
concept_sportsteam_indiana_pacers	concept_sportsleague_nba
concept_sportsteam_indiana_purdue_fort_wayne_mastodons	concept_sportsleague_ncaa
concept_sportsteam_indiana_state_sycamores	concept_sportsleague_ncaa
concept_sportsteam_indiana_university_of_pennsylvania	concept_sportsleague_ncaa
concept_sportsteam_indiana_wesleyan_wildcats	concept_sportsleague_ncaa
concept_sportsteam_indianapolis_greyhounds	concept_sportsleague_ncaa
concept_sportsteam_iona_college_gaels	concept_sportsleague_ncaa
concept_sportsteam_iona_gaels	concept_sportsleague_ncaa
concept_sportsteam_iowa_state	concept_sportsleague_ncaa
concept_sportsteam_ipfw_mastodons	concept_sportsleague_ncaa
concept_sportsteam_ithaca_college_bombers	concept_sportsleague_ncaa
concept_sportsteam_iupui_jaguars	concept_sportsleague_ncaa
concept_sportsteam_jackson_state_tigers	concept_sportsleague_ncaa
concept_sportsteam_jacksonville_dolphins	concept_sportsleague_ncaa
concept_sportsteam_jacksonville_state_gamecocks	concept_sportsleague_ncaa
concept_sportsteam_james_madison_dukes	concept_sportsleague_ncaa
concept_sportsteam_john_carroll_blue_streaks	concept_sportsleague_ncaa
concept_sportsteam_john_jay_bloodhounds	concept_sportsleague_ncaa
concept_sportsteam_johns_hopkins_blue_jays	concept_sportsleague_ncaa
concept_sportsteam_johnson_and_wales_wildcats	concept_sportsleague_ncaa
concept_sportsteam_ju_dolphins	concept_sportsleague_ncaa
concept_sportsteam_kansas_city_chiefs	concept_sportsleague_nfl
concept_sportsteam_kansas_city_royals	concept_sportsleague_mlb
concept_sportsteam_kansas_jayhawks	concept_sportsleague_ncaa
concept_sportsteam_kean_cougars	concept_sportsleague_ncaa
concept_sportsteam_kennesaw_state_owls	concept_sportsleague_ncaa
concept_sportsteam_kentucky_state_thorobreds	concept_sportsleague_ncaa
concept_sportsteam_kentucky_wildcats	concept_sportsleague_cfl
concept_sportsteam_kentucky_wildcats	concept_sportsleague_ncaa
concept_sportsteam_kenyon_lords	concept_sportsleague_ncaa
concept_sportsteam_kishwaukee_college_kougars	concept_sportsleague_ncaa
concept_sportsteam_knicks	concept_sportsleague_nba
concept_sportsteam_knicks	concept_sportsleague_nhl
concept_sportsteam_knox_college	concept_sportsleague_ncaa
concept_sportsteam_kutztown_golden_bears	concept_sportsleague_ncaa
concept_sportsteam_la_clippers	concept_sportsleague_nba
concept_sportsteam_la_salle_explorers	concept_sportsleague_ncaa
concept_sportsteam_lafayette_college	concept_sportsleague_ncaa
concept_sportsteam_lafayette_leopards	concept_sportsleague_ncaa
concept_sportsteam_lake_superior_state_lakers	concept_sportsleague_ncaa
concept_sportsteam_lamar_cardinals	concept_sportsleague_ncaa
concept_sportsteam_lamar_university_cardinals	concept_sportsleague_ncaa
concept_sportsteam_lambuth_eagles	concept_sportsleague_ncaa
concept_sportsteam_laurentian_university	concept_sportsleague_ncaa
concept_sportsteam_le_moyne_college_dolphins	concept_sportsleague_ncaa
concept_sportsteam_lees	concept_sportsleague_ncaa
concept_sportsteam_lehigh_mountain_hawks	concept_sportsleague_ncaa
concept_sportsteam_lenoir_rhyne_bears	concept_sportsleague_ncaa
concept_sportsteam_lewis_flyers	concept_sportsleague_ncaa
concept_sportsteam_liberty_flames	concept_sportsleague_ncaa
concept_sportsteam_liberty_university	concept_sportsleague_ncaa
concept_sportsteam_lincoln_blue_tigers	concept_sportsleague_ncaa
concept_sportsteam_lincoln_lions	concept_sportsleague_ncaa
concept_sportsteam_linfield_college_wildcats	concept_sportsleague_ncaa
concept_sportsteam_lipscomb_bisons	concept_sportsleague_ncaa
concept_sportsteam_long_beach_state_49ers	concept_sportsleague_ncaa
concept_sportsteam_long_island_blackbirds	concept_sportsleague_ncaa
concept_sportsteam_longwood_lancers	concept_sportsleague_ncaa
concept_sportsteam_los_angeles_clippers	concept_sportsleague_nba
concept_sportsteam_los_angeles_dodgers	concept_sportsleague_mlb
concept_sportsteam_los_angeles_lakers	concept_sportsleague_nba
concept_sportsteam_louisiana_college_wildcats	concept_sportsleague_ncaa
concept_sportsteam_louisiana_lafayette_ragin_cajuns	concept_sportsleague_ncaa
concept_sportsteam_louisiana_monroe_warhawks	concept_sportsleague_ncaa
concept_sportsteam_louisiana_state_shreveport_pilots	concept_sportsleague_ncaa
concept_sportsteam_louisiana_tech_bulldogs	concept_sportsleague_ncaa
concept_sportsteam_louisville_cardinals	concept_sportsleague_ncaa
concept_sportsteam_loyola_chicago_ramblers	concept_sportsleague_ncaa
concept_sportsteam_loyola_greyhounds	concept_sportsleague_ncaa
concept_sportsteam_loyola_marymount_lions	concept_sportsleague_ncaa
concept_sportsteam_loyola_new_orleans_wolfpack	concept_sportsleague_ncaa
concept_sportsteam_lsu	concept_sportsleague_ncaa
concept_sportsteam_lsu_tigers	concept_sportsleague_ncaa
concept_sportsteam_mac_gear	concept_sportsleague_ncaa
concept_sportsteam_maine_black_bears	concept_sportsleague_ncaa
concept_sportsteam_manhattan_jaspers	concept_sportsleague_ncaa
concept_sportsteam_mariners	concept_sportsleague_mlb
concept_sportsteam_marist_red_foxes	concept_sportsleague_ncaa
concept_sportsteam_marlins	concept_sportsleague_nfl
concept_sportsteam_marquette_golden_eagles	concept_sportsleague_ncaa
concept_sportsteam_marshall_thundering_herd	concept_sportsleague_ncaa
concept_sportsteam_mary_hardin_baylor_crusaders	concept_sportsleague_ncaa
concept_sportsteam_maryland	concept_sportsleague_ncaa
concept_sportsteam_maryland_terrapins	concept_sportsleague_ncaa
concept_sportsteam_massachusetts_maritime_academy_buccaneers	concept_sportsleague_ncaa
concept_sportsteam_massachusetts_minutemen	concept_sportsleague_ncaa
concept_sportsteam_mcneese_state_cowboys	concept_sportsleague_ncaa
concept_sportsteam_memphis_grizzlies	concept_sportsleague_nba
concept_sportsteam_memphis_tigers	concept_sportsleague_ncaa
concept_sportsteam_merced_blue_devils	concept_sportsleague_ncaa
concept_sportsteam_mercer_bears	concept_sportsleague_ncaa
concept_sportsteam_merrimack_college_warriors	concept_sportsleague_ncaa
concept_sportsteam_metro_state_roadrunners	concept_sportsleague_ncaa
concept_sportsteam_miaa	concept_sportsleague_ncaa
concept_sportsteam_miami_hurricanes	concept_sportsleague_ncaa
concept_sportsteam_miami_ohio_redhawks	concept_sportsleague_ncaa
concept_sportsteam_miami_university_redhawks	concept_sportsleague_ncaa
concept_sportsteam_michigan_state	concept_sportsleague_ncaa
concept_sportsteam_michigan_tech_huskies	concept_sportsleague_ncaa
concept_sportsteam_michigan_wolverines	concept_sportsleague_ncaa
concept_sportsteam_mid__tenn__st__blue_raiders	concept_sportsleague_ncaa
concept_sportsteam_middle_tennessee_state_blue_raiders	concept_sportsleague_ncaa
concept_sportsteam_midwestern_state_mustangs	concept_sportsleague_ncaa
concept_sportsteam_millikin_big_blue	concept_sportsleague_ncaa
concept_sportsteam_milwaukee_brewers	concept_sportsleague_mlb
concept_sportsteam_milwaukee_bucks	concept_sportsleague_nba
concept_sportsteam_minnesota_duluth_bulldogs	concept_sportsleague_ncaa
concept_sportsteam_minnesota_golden_gophers	concept_sportsleague_ncaa
concept_sportsteam_minnesota_lynx	concept_sportsleague_nba
concept_sportsteam_minnesota_state_mavericks	concept_sportsleague_ncaa
concept_sportsteam_minnesota_state_moorhead_dragons	concept_sportsleague_ncaa
concept_sportsteam_minnesota_timberwolves	concept_sportsleague_nba
concept_sportsteam_minnesota_twins	concept_sportsleague_mlb
concept_sportsteam_minnesota_twins	concept_sportsleague_nfl
concept_sportsteam_minnesota_vikings	concept_sportsleague_mlb
concept_sportsteam_minnesota_vikings	concept_sportsleague_nfl
concept_sportsteam_mississippi_rebels	concept_sportsleague_ncaa
concept_sportsteam_mississippi_state_bulldogs	concept_sportsleague_ncaa
concept_sportsteam_mississippi_state_university	concept_sportsleague_ncaa
concept_sportsteam_mississippi_valley_state_delta_devils	concept_sportsleague_ncaa
concept_sportsteam_missouri_kansas_city_kangaroos	concept_sportsleague_ncaa
concept_sportsteam_missouri_southern_state_lions	concept_sportsleague_ncaa
concept_sportsteam_missouri_state_bears	concept_sportsleague_ncaa
concept_sportsteam_missouri_state_west_plains_grizzlies	concept_sportsleague_ncaa
concept_sportsteam_missouri_tigers	concept_sportsleague_ncaa
concept_sportsteam_missouri_western_state_griffons	concept_sportsleague_ncaa
concept_sportsteam_mit_engineers	concept_sportsleague_ncaa
concept_sportsteam_mitchell_college_pequots	concept_sportsleague_ncaa
concept_sportsteam_mobile_rams	concept_sportsleague_ncaa
concept_sportsteam_monmouth_college	concept_sportsleague_ncaa
concept_sportsteam_monmouth_hawks	concept_sportsleague_ncaa
concept_sportsteam_montana_grizzlies	concept_sportsleague_ncaa
concept_sportsteam_montana_state	concept_sportsleague_ncaa
concept_sportsteam_montana_state_billings_yellowjackets	concept_sportsleague_ncaa
concept_sportsteam_montana_tech_orediggers	concept_sportsleague_ncaa
concept_sportsteam_montana_western_bulldogs	concept_sportsleague_ncaa
concept_sportsteam_montclair_state_red_hawks	concept_sportsleague_ncaa
concept_sportsteam_montevallo_falcons	concept_sportsleague_ncaa
concept_sportsteam_moravian_greyhounds	concept_sportsleague_ncaa
concept_sportsteam_morehead_state_eagles	concept_sportsleague_ncaa
concept_sportsteam_morehouse_maroon_tigers	concept_sportsleague_ncaa
concept_sportsteam_morgan_state_bears	concept_sportsleague_ncaa
concept_sportsteam_mount_st__mary_s_mountaineers	concept_sportsleague_ncaa
concept_sportsteam_mount_st_marys_mountaineers	concept_sportsleague_ncaa
concept_sportsteam_mount_union_purple_raiders	concept_sportsleague_ncaa
concept_sportsteam_muhlenberg_college_mules	concept_sportsleague_ncaa
concept_sportsteam_murray_st__racers	concept_sportsleague_ncaa
concept_sportsteam_murray_state_racers	concept_sportsleague_ncaa
concept_sportsteam_mvc_gear	concept_sportsleague_ncaa
concept_sportsteam_mwc_gear	concept_sportsleague_ncaa
concept_sportsteam_navy_midshipmen	concept_sportsleague_ncaa
concept_sportsteam_nc_central_eagles	concept_sportsleague_ncaa
concept_sportsteam_nc_state	concept_sportsleague_ncaa
concept_sportsteam_ncaa_mens_midwest_regionals	concept_sportsleague_ncaa
concept_sportsteam_ncaa_youth_kids	concept_sportsleague_ncaa
concept_sportsteam_nebraska_cornhuskers	concept_sportsleague_ncaa
concept_sportsteam_nebraska_kearney_lopers	concept_sportsleague_ncaa
concept_sportsteam_nebraska_omaha_mavericks	concept_sportsleague_ncaa
concept_sportsteam_nec_gear	concept_sportsleague_ncaa
concept_sportsteam_nevada_wolfpack	concept_sportsleague_ncaa
concept_sportsteam_new_hampshire_wildcats	concept_sportsleague_ncaa
concept_sportsteam_new_jersey_institute_of_technology_highlanders	concept_sportsleague_ncaa
concept_sportsteam_new_mexico_lobos	concept_sportsleague_ncaa
concept_sportsteam_new_mexico_state_aggies	concept_sportsleague_ncaa
concept_sportsteam_new_orleans_hornets	concept_sportsleague_nba
concept_sportsteam_new_orleans_hornets	concept_sportsleague_nfl
concept_sportsteam_new_orleans_privateers	concept_sportsleague_ncaa
concept_sportsteam_new_paltz_hawks	concept_sportsleague_ncaa
concept_sportsteam_new_york_giants	concept_sportsleague_nfl
concept_sportsteam_new_york_jets	concept_sportsleague_nfl
concept_sportsteam_new_york_liberty	concept_sportsleague_nba
concept_sportsteam_new_york_liberty	concept_sportsleague_nhl
concept_sportsteam_new_york_mets	concept_sportsleague_mlb
concept_sportsteam_newman_jets	concept_sportsleague_ncaa
concept_sportsteam_niagara_purple_eagles	concept_sportsleague_ncaa
concept_sportsteam_nicholls_state_colonels	concept_sportsleague_ncaa
concept_sportsteam_nicholls_state_university	concept_sportsleague_ncaa
concept_sportsteam_nittany_lions	concept_sportsleague_ncaa
concept_sportsteam_njit_highlanders	concept_sportsleague_ncaa
concept_sportsteam_norfolk_state_spartans	concept_sportsleague_ncaa
concept_sportsteam_north_alabama_lions	concept_sportsleague_ncaa
concept_sportsteam_north_carolina_a_and_t_aggies	concept_sportsleague_ncaa
concept_sportsteam_north_carolina_a_t_aggies	concept_sportsleague_ncaa
concept_sportsteam_north_carolina_central_university_eagles	concept_sportsleague_ncaa
concept_sportsteam_north_carolina_tar_heels	concept_sportsleague_ncaa
concept_sportsteam_north_central_cardinals	concept_sportsleague_ncaa
concept_sportsteam_north_dakota_fighting_sioux	concept_sportsleague_ncaa
concept_sportsteam_north_dakota_state_bison	concept_sportsleague_ncaa
concept_sportsteam_north_florida_ospreys	concept_sportsleague_ncaa
concept_sportsteam_north_park_vikings	concept_sportsleague_ncaa
concept_sportsteam_north_texas_mean_green	concept_sportsleague_ncaa
concept_sportsteam_northeast_wisconsin_technical_college	concept_sportsleague_ncaa
concept_sportsteam_northeastern_huskies	concept_sportsleague_ncaa
concept_sportsteam_northeastern_illinois_golden_eagles	concept_sportsleague_ncaa
concept_sportsteam_northeastern_state_riverhawks	concept_sportsleague_ncaa
concept_sportsteam_northern_arizona_lumberjacks	concept_sportsleague_ncaa
concept_sportsteam_northern_colorado_bears	concept_sportsleague_ncaa
concept_sportsteam_northern_illinois_huskies	concept_sportsleague_ncaa
concept_sportsteam_northern_iowa_panthers	concept_sportsleague_ncaa
concept_sportsteam_northern_kentucky_norse	concept_sportsleague_ncaa
concept_sportsteam_northern_kentucky_university_norse	concept_sportsleague_ncaa
concept_sportsteam_northern_michigan_wildcats	concept_sportsleague_ncaa
concept_sportsteam_northern_state_university	concept_sportsleague_ncaa
concept_sportsteam_northwest_missouri_state_bearcats	concept_sportsleague_ncaa
concept_sportsteam_northwestern_state_demons	concept_sportsleague_ncaa
concept_sportsteam_northwestern_wildcats	concept_sportsleague_ncaa
concept_sportsteam_northwood_timberwolves	concept_sportsleague_ncaa
concept_sportsteam_notre_dame	concept_sportsleague_ncaa
concept_sportsteam_nova_southeastern_sharks	concept_sportsleague_ncaa
concept_sportsteam_nyu_violets	concept_sportsleague_ncaa
concept_sportsteam_oakland_athletics	concept_sportsleague_mlb
concept_sportsteam_oakland_athletics	concept_sportsleague_nfl
concept_sportsteam_oakland_golden_grizzlies	concept_sportsleague_ncaa
concept_sportsteam_oakland_raiders	concept_sportsleague_mlb
concept_sportsteam_oakland_raiders	concept_sportsleague_nfl
concept_sportsteam_oakland_university	concept_sportsleague_ncaa
concept_sportsteam_ohio_bobcats	concept_sportsleague_ncaa
concept_sportsteam_ohio_dominican_panthers	concept_sportsleague_ncaa
concept_sportsteam_ohio_northern_polar_bears	concept_sportsleague_ncaa
concept_sportsteam_ohio_state_buckeyes	concept_sportsleague_ncaa
concept_sportsteam_ohio_state_university	concept_sportsleague_ncaa
concept_sportsteam_oilers	concept_sportsleague_nfl
concept_sportsteam_oklahoma_baptist_bison	concept_sportsleague_ncaa
concept_sportsteam_oklahoma_city_university_stars	concept_sportsleague_ncaa
concept_sportsteam_oklahoma_state_cowboys	concept_sportsleague_ncaa
concept_sportsteam_old_dominion_monarchs	concept_sportsleague_ncaa
concept_sportsteam_ole_miss_rebels	concept_sportsleague_ncaa
concept_sportsteam_olivet_college_comets	concept_sportsleague_ncaa
concept_sportsteam_olympic_college_rangers	concept_sportsleague_ncaa
concept_sportsteam_oral_roberts_golden_eagles	concept_sportsleague_ncaa
concept_sportsteam_oregon_ducks	concept_sportsleague_ncaa
concept_sportsteam_oregon_state_beavers	concept_sportsleague_ncaa
concept_sportsteam_orioles	concept_sportsleague_mlb
concept_sportsteam_oswego_state_lakers	concept_sportsleague_ncaa
concept_sportsteam_pac_10_gear	concept_sportsleague_ncaa
concept_sportsteam_pace_university_setters	concept_sportsleague_ncaa
concept_sportsteam_pacers	concept_sportsleague_nba
concept_sportsteam_pacific_boxers	concept_sportsleague_ncaa
concept_sportsteam_pacific_tigers	concept_sportsleague_ncaa
concept_sportsteam_parsons_school_of_design	concept_sportsleague_ncaa
concept_sportsteam_pasadena_city_college_lancers	concept_sportsleague_ncaa
concept_sportsteam_pellissippi_state_purple_panthers	concept_sportsleague_ncaa
concept_sportsteam_peninsula_college_pirates	concept_sportsleague_ncaa
concept_sportsteam_penn_state_nittany_lions	concept_sportsleague_ncaa
concept_sportsteam_pennsylvania_quakers	concept_sportsleague_ncaa
concept_sportsteam_pepperdine_waves	concept_sportsleague_ncaa
concept_sportsteam_pfeiffer_falcons	concept_sportsleague_ncaa
concept_sportsteam_philadelphia_76ers	concept_sportsleague_nba
concept_sportsteam_philadelphia_phillies	concept_sportsleague_mlb
concept_sportsteam_pierce_college_raiders	concept_sportsleague_ncaa
concept_sportsteam_pinstripe_bowl_gear	concept_sportsleague_ncaa
concept_sportsteam_pistons	concept_sportsleague_nba
concept_sportsteam_pittsburg_state_gorillas	concept_sportsleague_ncaa
concept_sportsteam_pittsburgh_panthers	concept_sportsleague_ncaa
concept_sportsteam_pittsburgh_penguins	concept_sportsleague_nhl
concept_sportsteam_pittsburgh_pirates	concept_sportsleague_mlb
concept_sportsteam_plattsburgh_state_cardinals	concept_sportsleague_ncaa
concept_sportsteam_portland_pilots	concept_sportsleague_ncaa
concept_sportsteam_portland_state_vikings	concept_sportsleague_ncaa
concept_sportsteam_portland_trailblazers	concept_sportsleague_nba
concept_sportsteam_prairie_view_a_and_m_panthers	concept_sportsleague_ncaa
concept_sportsteam_presbyterian_blue_hose	concept_sportsleague_ncaa
concept_sportsteam_presbyterian_college	concept_sportsleague_ncaa
concept_sportsteam_princeton_theological_seminary	concept_sportsleague_ncaa
concept_sportsteam_princeton_tigers	concept_sportsleague_ncaa
concept_sportsteam_providence_friars	concept_sportsleague_ncaa
concept_sportsteam_puget_sound_loggers	concept_sportsleague_ncaa
concept_sportsteam_purdue_boilermakers	concept_sportsleague_ncaa
concept_sportsteam_queens_college	concept_sportsleague_ncaa
concept_sportsteam_quinnipiac_bobcats	concept_sportsleague_ncaa
concept_sportsteam_radford_highlanders	concept_sportsleague_ncaa
concept_sportsteam_raptors	concept_sportsleague_nba
concept_sportsteam_raptors	concept_sportsleague_nhl
concept_sportsteam_ravens	concept_sportsleague_nfl
concept_sportsteam_reds	concept_sportsleague_mlb
concept_sportsteam_redskins	concept_sportsleague_nfl
concept_sportsteam_reedley_college_tigers	concept_sportsleague_ncaa
concept_sportsteam_regis_rangers	concept_sportsleague_ncaa
concept_sportsteam_rensselaer_polytechnic_institute_engineers	concept_sportsleague_ncaa
concept_sportsteam_rhode_island_anchormen	concept_sportsleague_ncaa
concept_sportsteam_rhode_island_rams	concept_sportsleague_ncaa
concept_sportsteam_rice_owls	concept_sportsleague_ncaa
concept_sportsteam_richmond_spiders	concept_sportsleague_ncaa
concept_sportsteam_rider_broncs	concept_sportsleague_ncaa
concept_sportsteam_robert_morris_colonials	concept_sportsleague_ncaa
concept_sportsteam_robert_morris_eagles	concept_sportsleague_ncaa
concept_sportsteam_rochester_college	concept_sportsleague_ncaa
concept_sportsteam_rochester_institute_of_technology_tigers	concept_sportsleague_ncaa
concept_sportsteam_rochester_yellow_jackets	concept_sportsleague_ncaa
concept_sportsteam_rockets	concept_sportsleague_nba
concept_sportsteam_rose_bowl_gear	concept_sportsleague_ncaa
concept_sportsteam_rowan_owls	concept_sportsleague_ncaa
concept_sportsteam_rpi_engineers	concept_sportsleague_ncaa
concept_sportsteam_rutgers	concept_sportsleague_ncaa
concept_sportsteam_rutgers_scarlet_knights	concept_sportsleague_ncaa
concept_sportsteam_sacramento_kings	concept_sportsleague_nba
concept_sportsteam_sacramento_state	concept_sportsleague_ncaa
concept_sportsteam_sacred_heart_pioneers	concept_sportsleague_ncaa
concept_sportsteam_saginaw_valley_state_cardinals	concept_sportsleague_ncaa
concept_sportsteam_saginaw_valley_state_university	concept_sportsleague_ncaa
concept_sportsteam_saint_francis_red_flash	concept_sportsleague_ncaa
concept_sportsteam_saint_joseph_s_college_pumas	concept_sportsleague_ncaa
concept_sportsteam_saint_joseph_s_hawks	concept_sportsleague_ncaa
concept_sportsteam_saint_josephs_college_pumas	concept_sportsleague_ncaa
concept_sportsteam_saint_josephs_hawks	concept_sportsleague_ncaa
concept_sportsteam_saint_louis_billikens	concept_sportsleague_ncaa
concept_sportsteam_saint_mary_s_gaels	concept_sportsleague_ncaa
concept_sportsteam_saint_marys_gaels	concept_sportsleague_ncaa
concept_sportsteam_saint_peter_s_peacocks	concept_sportsleague_ncaa
concept_sportsteam_saint_peters_peacocks	concept_sportsleague_ncaa
concept_sportsteam_sam_houston_state_bearkats	concept_sportsleague_ncaa
concept_sportsteam_samford_bulldogs	concept_sportsleague_ncaa
concept_sportsteam_samuel_merrit_university	concept_sportsleague_ncaa
concept_sportsteam_san_diego_padres	concept_sportsleague_nfl
concept_sportsteam_san_diego_state_aztecs	concept_sportsleague_ncaa
concept_sportsteam_san_diego_toreros	concept_sportsleague_ncaa
concept_sportsteam_san_francisco_49ers	concept_sportsleague_nfl
concept_sportsteam_san_francisco_dons	concept_sportsleague_ncaa
concept_sportsteam_san_francisco_state_gators	concept_sportsleague_ncaa
concept_sportsteam_santa_clara_broncos	concept_sportsleague_ncaa
concept_sportsteam_savannah_state_tigers	concept_sportsleague_ncaa
concept_sportsteam_scranton_royals	concept_sportsleague_ncaa
concept_sportsteam_sd_chargers	concept_sportsleague_nfl
concept_sportsteam_se_missouri_state	concept_sportsleague_ncaa
concept_sportsteam_seahawks	concept_sportsleague_ncaa
concept_sportsteam_seattle_mariners	concept_sportsleague_mlb
concept_sportsteam_seattle_redhawks	concept_sportsleague_ncaa
concept_sportsteam_sec_gear	concept_sportsleague_ncaa
concept_sportsteam_seton_hall_pirates	concept_sportsleague_ncaa
concept_sportsteam_seton_hill_griffins	concept_sportsleague_ncaa
concept_sportsteam_sewanee_tigers	concept_sportsleague_ncaa
concept_sportsteam_shenandoah_hornets	concept_sportsleague_ncaa
concept_sportsteam_shippensburg_raiders	concept_sportsleague_ncaa
concept_sportsteam_siena_saints	concept_sportsleague_ncaa
concept_sportsteam_siu_edwardsville_cougars	concept_sportsleague_ncaa
concept_sportsteam_slippery_rock_pride	concept_sportsleague_ncaa
concept_sportsteam_smu_mustangs	concept_sportsleague_ncaa
concept_sportsteam_sonics	concept_sportsleague_nba
concept_sportsteam_sonoma_state_seawolves	concept_sportsleague_ncaa
concept_sportsteam_south_alabama_jaguars	concept_sportsleague_ncaa
concept_sportsteam_south_carolina_gamecocks	concept_sportsleague_ncaa
concept_sportsteam_south_carolina_state_bulldogs	concept_sportsleague_ncaa
concept_sportsteam_south_dakota_coyotes	concept_sportsleague_ncaa
concept_sportsteam_south_dakota_st_jackrabbits	concept_sportsleague_ncaa
concept_sportsteam_south_dakota_state_jackrabbits	concept_sportsleague_ncaa
concept_sportsteam_south_florida_bulls	concept_sportsleague_ncaa
concept_sportsteam_southeast_missouri_state_redhawks	concept_sportsleague_ncaa
concept_sportsteam_southeastern_fire	concept_sportsleague_ncaa
concept_sportsteam_southeastern_louisiana_lions	concept_sportsleague_ncaa
concept_sportsteam_southern_arkansas_muleriders	concept_sportsleague_ncaa
concept_sportsteam_southern_conference_gear	concept_sportsleague_ncaa
concept_sportsteam_southern_connecticut_state_o	concept_sportsleague_ncaa
concept_sportsteam_southern_illinois	concept_sportsleague_ncaa
concept_sportsteam_southern_illinois_salukis	concept_sportsleague_ncaa
concept_sportsteam_southern_indiana_screaming_eagles	concept_sportsleague_ncaa
concept_sportsteam_southern_jaguars	concept_sportsleague_ncaa
concept_sportsteam_southern_methodist_mustangs	concept_sportsleague_ncaa
concept_sportsteam_southern_miss_golden_eagles	concept_sportsleague_ncaa
concept_sportsteam_southern_mississippi_golden_eagles	concept_sportsleague_ncaa
concept_sportsteam_southern_new_hampshire_penmen	concept_sportsleague_ncaa
concept_sportsteam_southern_university_at_new_orleans_knights	concept_sportsleague_ncaa
concept_sportsteam_southern_university_jaguars	concept_sportsleague_ncaa
concept_sportsteam_southern_utah_thunderbirds	concept_sportsleague_ncaa
concept_sportsteam_southern_virginia_knights	concept_sportsleague_ncaa
concept_sportsteam_southwestern_oklahoma_state_bulldogs	concept_sportsleague_ncaa
concept_sportsteam_spelman_college_jaguars	concept_sportsleague_ncaa
concept_sportsteam_springfield_college_pride	concept_sportsleague_ncaa
concept_sportsteam_st___louis_cardinals	concept_sportsleague_mlb
concept_sportsteam_st__bonaventure_bonnies	concept_sportsleague_ncaa
concept_sportsteam_st__cloud_state_huskies	concept_sportsleague_ncaa
concept_sportsteam_st__francis_college_terriers	concept_sportsleague_ncaa
concept_sportsteam_st__johns_red_storm	concept_sportsleague_ncaa
concept_sportsteam_st__louis_cardinals	concept_sportsleague_mlb
concept_sportsteam_st__norbert_green_knights	concept_sportsleague_ncaa
concept_sportsteam_st_cloud_state_huskies	concept_sportsleague_ncaa
concept_sportsteam_st_francis_college_terriers	concept_sportsleague_ncaa
concept_sportsteam_st_johns_red_storm	concept_sportsleague_ncaa
concept_sportsteam_st_norbert_green_knights	concept_sportsleague_ncaa
concept_sportsteam_stanford	concept_sportsleague_ncaa
concept_sportsteam_steelers	concept_sportsleague_nfl
concept_sportsteam_stephen_f_austin_lumberjacks	concept_sportsleague_ncaa
concept_sportsteam_stetson_hatters	concept_sportsleague_ncaa
concept_sportsteam_stillman_tigers	concept_sportsleague_ncaa
concept_sportsteam_stony_brook_seawolves	concept_sportsleague_ncaa
concept_sportsteam_sun_belt_gear	concept_sportsleague_ncaa
concept_sportsteam_suns	concept_sportsleague_nba
concept_sportsteam_suny_cortland_red_dragons	concept_sportsleague_ncaa
concept_sportsteam_susquehanna_crusaders	concept_sportsleague_ncaa
concept_sportsteam_syracuse_orangemen	concept_sportsleague_ncaa
concept_sportsteam_talladega_college_tornadoes	concept_sportsleague_ncaa
concept_sportsteam_tampa_bay_devil_rays	concept_sportsleague_mlb
concept_sportsteam_tampa_spartans	concept_sportsleague_ncaa
concept_sportsteam_tarleton_state_texans	concept_sportsleague_ncaa
concept_sportsteam_tcu_horned_frogs	concept_sportsleague_ncaa
concept_sportsteam_temple_owls	concept_sportsleague_ncaa
concept_sportsteam_tennessee_chattanooga_mocs	concept_sportsleague_ncaa
concept_sportsteam_tennessee_martin_skyhawks	concept_sportsleague_ncaa
concept_sportsteam_tennessee_state_tigers	concept_sportsleague_ncaa
concept_sportsteam_tennessee_tech_golden_eagles	concept_sportsleague_ncaa
concept_sportsteam_tennessee_volunteers	concept_sportsleague_ncaa
concept_sportsteam_tennessee_wesleyan_bulldogs	concept_sportsleague_ncaa
concept_sportsteam_texas_a_and_m_aggies	concept_sportsleague_ncaa
concept_sportsteam_texas_a_and_m_commerce_lions	concept_sportsleague_ncaa
concept_sportsteam_texas_a_and_m_corpus_christi_islanders	concept_sportsleague_ncaa
concept_sportsteam_texas_a_and_m_kingsville_javelinas	concept_sportsleague_ncaa
concept_sportsteam_texas_a_m	concept_sportsleague_ncaa
concept_sportsteam_texas_a_m_aggies	concept_sportsleague_ncaa
concept_sportsteam_texas_a_m_corpus_christi_islanders	concept_sportsleague_ncaa
concept_sportsteam_texas_brownsville_scorpions	concept_sportsleague_ncaa
concept_sportsteam_texas_christian	concept_sportsleague_ncaa
concept_sportsteam_texas_college_steers	concept_sportsleague_ncaa
concept_sportsteam_texas_longhorns	concept_sportsleague_ncaa
concept_sportsteam_texas_pan_american_broncos	concept_sportsleague_ncaa
concept_sportsteam_texas_rangers	concept_sportsleague_mlb
concept_sportsteam_texas_san_antonio_roadrunners	concept_sportsleague_ncaa
concept_sportsteam_texas_southern_tigers	concept_sportsleague_ncaa
concept_sportsteam_texas_state_bobcats	concept_sportsleague_ncaa
concept_sportsteam_texas_tech_red_raiders	concept_sportsleague_ncaa
concept_sportsteam_texas_tyler_patriots	concept_sportsleague_ncaa
concept_sportsteam_the_master_s_college_mustangs	concept_sportsleague_ncaa
concept_sportsteam_the_masters_college_mustangs	concept_sportsleague_ncaa
concept_sportsteam_thomas_night_hawks	concept_sportsleague_ncaa
concept_sportsteam_titans	concept_sportsleague_nfl
concept_sportsteam_toledo_rockets	concept_sportsleague_ncaa
concept_sportsteam_toronto_blue_jays	concept_sportsleague_cfl
concept_sportsteam_toronto_blue_jays	concept_sportsleague_mlb
concept_sportsteam_towson_tigers	concept_sportsleague_ncaa
concept_sportsteam_trail_blazers	concept_sportsleague_nba
concept_sportsteam_transylvania	concept_sportsleague_ncaa
concept_sportsteam_troy_trojans	concept_sportsleague_ncaa
concept_sportsteam_troy_university_trojans	concept_sportsleague_ncaa
concept_sportsteam_tufts_jumbos	concept_sportsleague_ncaa
concept_sportsteam_tulane_green_wave	concept_sportsleague_ncaa
concept_sportsteam_tulsa_golden_hurricane	concept_sportsleague_ncaa
concept_sportsteam_tuskegee_golden_tigers	concept_sportsleague_ncaa
concept_sportsteam_uab_blazers	concept_sportsleague_ncaa
concept_sportsteam_uc_davis_aggies	concept_sportsleague_ncaa
concept_sportsteam_uc_irvine_anteaters	concept_sportsleague_ncaa
concept_sportsteam_uc_riverside_highlanders	concept_sportsleague_ncaa
concept_sportsteam_uc_san_diego_tritons	concept_sportsleague_ncaa
concept_sportsteam_uc_santa_barbara_gauchos	concept_sportsleague_ncaa
concept_sportsteam_uc_santa_cruz_slugs	concept_sportsleague_ncaa
concept_sportsteam_ucf_knights	concept_sportsleague_ncaa
concept_sportsteam_ucla	concept_sportsleague_ncaa
concept_sportsteam_uic_flames	concept_sportsleague_ncaa
concept_sportsteam_umass_dartmouth_corsairs	concept_sportsleague_ncaa
concept_sportsteam_umass_lowell_river_hawks	concept_sportsleague_ncaa
concept_sportsteam_umass_minutemen	concept_sportsleague_ncaa
concept_sportsteam_umbc_retrievers	concept_sportsleague_ncaa
concept_sportsteam_umkc_kangaroos	concept_sportsleague_ncaa
concept_sportsteam_unc_asheville_bulldogs	concept_sportsleague_ncaa
concept_sportsteam_unc_wilmington_seahawks	concept_sportsleague_ncaa
concept_sportsteam_uncg_spartans	concept_sportsleague_ncaa
concept_sportsteam_unf_ospreys	concept_sportsleague_ncaa
concept_sportsteam_university_of_illinois	concept_sportsleague_ncaa
concept_sportsteam_university_of_north_alabama_lions	concept_sportsleague_ncaa
concept_sportsteam_university_of_redlands_bulldogs	concept_sportsleague_ncaa
concept_sportsteam_university_of_south_alabama_jaguars	concept_sportsleague_ncaa
concept_sportsteam_unlv_runnin_rebels	concept_sportsleague_ncaa
concept_sportsteam_usc	concept_sportsleague_ncaa
concept_sportsteam_usc_upstate_spartans	concept_sportsleague_ncaa
concept_sportsteam_ut_arlington_mavericks	concept_sportsleague_ncaa
concept_sportsteam_utah_jazz	concept_sportsleague_nba
concept_sportsteam_utah_utes	concept_sportsleague_ncaa
concept_sportsteam_utah_valley_university_wolverines	concept_sportsleague_ncaa
concept_sportsteam_utah_valley_wolverines	concept_sportsleague_ncaa
concept_sportsteam_utd_comets	concept_sportsleague_ncaa
concept_sportsteam_utep_miners	concept_sportsleague_ncaa
concept_sportsteam_valdosta_state_blazers	concept_sportsleague_ncaa
concept_sportsteam_valparaiso_crusaders	concept_sportsleague_ncaa
concept_sportsteam_vanderbilt_commodores	concept_sportsleague_ncaa
concept_sportsteam_vanguard_lions	concept_sportsleague_ncaa
concept_sportsteam_vcu_rams	concept_sportsleague_ncaa
concept_sportsteam_vermont_catamounts	concept_sportsleague_ncaa
concept_sportsteam_villanova_wildcats	concept_sportsleague_ncaa
concept_sportsteam_virginia_cavaliers	concept_sportsleague_ncaa
concept_sportsteam_virginia_military_institute_keydets	concept_sportsleague_ncaa
concept_sportsteam_virginia_state_trojans	concept_sportsleague_ncaa
concept_sportsteam_virginia_tech_hokies	concept_sportsleague_ncaa
concept_sportsteam_vmi_keydets	concept_sportsleague_ncaa
concept_sportsteam_wac_gear	concept_sportsleague_ncaa
concept_sportsteam_wagner_college_seahawks	concept_sportsleague_ncaa
concept_sportsteam_wagner_seahawks	concept_sportsleague_ncaa
concept_sportsteam_wake_forest	concept_sportsleague_ncaa
concept_sportsteam_wake_forest_demon_deacons	concept_sportsleague_ncaa
concept_sportsteam_washburn_ichabods	concept_sportsleague_ncaa
concept_sportsteam_washington_and_lee_generals	concept_sportsleague_ncaa
concept_sportsteam_washington_huskies	concept_sportsleague_ncaa
concept_sportsteam_washington_st__louis	concept_sportsleague_ncaa
concept_sportsteam_washington_st_louis	concept_sportsleague_ncaa
concept_sportsteam_washington_state	concept_sportsleague_ncaa
concept_sportsteam_washington_wizards	concept_sportsleague_nba
concept_sportsteam_washington_wizards	concept_sportsleague_nhl
concept_sportsteam_wayland_baptist_pioneers	concept_sportsleague_ncaa
concept_sportsteam_wayne_state_warriors	concept_sportsleague_ncaa
concept_sportsteam_weber_state_wildcats	concept_sportsleague_ncaa
concept_sportsteam_webster_gorlocks	concept_sportsleague_ncaa
concept_sportsteam_wesleyan_cardinals	concept_sportsleague_ncaa
concept_sportsteam_wesleyan_college_pioneers	concept_sportsleague_ncaa
concept_sportsteam_west_chester_golden_rams	concept_sportsleague_ncaa
concept_sportsteam_west_florida_argonauts	concept_sportsleague_ncaa
concept_sportsteam_west_georgia_wolves	concept_sportsleague_ncaa
concept_sportsteam_west_la_college_wildcats	concept_sportsleague_ncaa
concept_sportsteam_west_texas_a_and_m_buffalo	concept_sportsleague_ncaa
concept_sportsteam_west_texas_a_m_buffalo	concept_sportsleague_ncaa
concept_sportsteam_west_virginia_mountaineers	concept_sportsleague_ncaa
concept_sportsteam_west_virginia_state_yellow_jackets	concept_sportsleague_ncaa
concept_sportsteam_western_carolina_catamounts	concept_sportsleague_ncaa
concept_sportsteam_western_connecticut_colonials	concept_sportsleague_ncaa
concept_sportsteam_western_illinois	concept_sportsleague_ncaa
concept_sportsteam_western_kentucky_hilltoppers	concept_sportsleague_ncaa
concept_sportsteam_western_michigan_broncos	concept_sportsleague_ncaa
concept_sportsteam_western_oregon_wolves	concept_sportsleague_ncaa
concept_sportsteam_western_washington_vikings	concept_sportsleague_ncaa
concept_sportsteam_westminster_griffins	concept_sportsleague_ncaa
concept_sportsteam_wichita_state	concept_sportsleague_ncaa
concept_sportsteam_wichita_state_shockers	concept_sportsleague_ncaa
concept_sportsteam_widener_pride	concept_sportsleague_ncaa
concept_sportsteam_wilkes_colonels	concept_sportsleague_ncaa
concept_sportsteam_william_and_mary_tribe	concept_sportsleague_ncaa
concept_sportsteam_william_carey_crusaders	concept_sportsleague_ncaa
concept_sportsteam_william_paterson_pioneers	concept_sportsleague_ncaa
concept_sportsteam_william_penn_statesmen	concept_sportsleague_ncaa
concept_sportsteam_winston_salem_state_rams	concept_sportsleague_ncaa
concept_sportsteam_winthrop_eagles	concept_sportsleague_ncaa
concept_sportsteam_wisconsin_badgers	concept_sportsleague_ncaa
concept_sportsteam_wisconsin_eau_claire_blugold	concept_sportsleague_ncaa
concept_sportsteam_wisconsin_green_bay_phoenix	concept_sportsleague_ncaa
concept_sportsteam_wisconsin_la_crosse_eagles	concept_sportsleague_ncaa
concept_sportsteam_wisconsin_lutheran_college_warriors	concept_sportsleague_ncaa
concept_sportsteam_wisconsin_milwaukee_panthers	concept_sportsleague_ncaa
concept_sportsteam_wisconsin_oshkosh_titans	concept_sportsleague_ncaa
concept_sportsteam_wisconsin_parkside_rangers	concept_sportsleague_ncaa
concept_sportsteam_wisconsin_platteville_pioneers	concept_sportsleague_ncaa
concept_sportsteam_wisconsin_river_falls_falcons	concept_sportsleague_ncaa
concept_sportsteam_wisconsin_stevens_point_pointers	concept_sportsleague_ncaa
concept_sportsteam_wisconsin_stout_blue_devils	concept_sportsleague_ncaa
concept_sportsteam_wisconsin_whitewater_warhawks	concept_sportsleague_ncaa
concept_sportsteam_wittenberg_tigers	concept_sportsleague_ncaa
concept_sportsteam_wofford_terriers	concept_sportsleague_ncaa
concept_sportsteam_wooster_fighting_scots	concept_sportsleague_ncaa
concept_sportsteam_wright_state_raiders	concept_sportsleague_ncaa
concept_sportsteam_xavier_musketeers	concept_sportsleague_ncaa
concept_sportsteam_yale_bulldogs	concept_sportsleague_ncaa
concept_sportsteam_yankees	concept_sportsleague_mlb
concept_sportsteam_youngstown_state_penguins	concept_sportsleague_ncaa
concept_stateorprovince_california	concept_sportsleague_ncaa
concept_stateorprovince_colorado	concept_sportsleague_ncaa
concept_stateorprovince_georgia	concept_sportsleague_ncaa
concept_stateorprovince_illinois	concept_sportsleague_ncaa
concept_stateorprovince_indiana	concept_sportsleague_ncaa
concept_stateorprovince_iowa_hawkeyes	concept_sportsleague_ncaa
concept_stateorprovince_mississippi_state	concept_sportsleague_ncaa
concept_stateorprovince_oklahoma	concept_sportsleague_ncaa
concept_stateorprovince_ole_miss	concept_sportsleague_ncaa
concept_stateorprovince_oregon	concept_sportsleague_ncaa
concept_stateorprovince_south_carolina	concept_sportsleague_ncaa
concept_stateorprovince_tennessee	concept_sportsleague_ncaa
concept_stateorprovince_virginia	concept_sportsleague_ncaa
concept_stateorprovince_wyoming_cowboys	concept_sportsleague_ncaa
concept_terroristorganization_the_organization	concept_sportsleague_nfl
concept_university_alabama	concept_sportsleague_ncaa
concept_university_arkansas_little_rock_trojans	concept_sportsleague_ncaa
concept_university_auburn	concept_sportsleague_ncaa
concept_university_butler	concept_sportsleague_ncaa
concept_university_carolina	concept_sportsleague_ncaa
concept_university_clemson	concept_sportsleague_ncaa
concept_university_connecticut	concept_sportsleague_ncaa
concept_university_depaul	concept_sportsleague_ncaa
concept_university_kentucky	concept_sportsleague_ncaa
concept_university_ku	concept_sportsleague_ncaa
concept_university_memphis	concept_sportsleague_ncaa
concept_university_montana_state_billings	concept_sportsleague_ncaa
concept_university_purdue	concept_sportsleague_ncaa
concept_university_seton_hall	concept_sportsleague_ncaa
concept_university_southern_cal	concept_sportsleague_ncaa
concept_university_stanford	concept_sportsleague_ncaa
concept_university_uconn	concept_sportsleague_ncaa
concept_university_university_of_virginia	concept_sportsleague_ncaa
concept_university_usf	concept_sportsleague_ncaa
concept_university_utah_state	concept_sportsleague_ncaa
concept_university_utah_valley_university	concept_sportsleague_ncaa
concept_university_uw	concept_sportsleague_ncaa
concept_university_villanova	concept_sportsleague_ncaa
